ID,TITLE,ORIGINAL TITLE,SCORE,YEAR,BUDGET,GROSS,BENEFIT,CATEGORY,RUNTIME
1271,300,300,7.1,2006,65000000,422610419,357610419,Vista,117
53182,300: El origen de un imperio,300: Rise of an Empire,6.1,2014,110000000,337580051,227580051,Vista,102
300671,13 horas: los soldados secretos de Bengasi,13 Hours: The Secret Soldiers of Benghazi,7.2,2016,50000000,69411370,19411370,Vista,144
1771,Capitán América: El primer vengador,Captain America: The First Avenger,6.9,2011,140000000,370569774,230569774,Vista,124
100402,Capitán América: El soldado de invierno,Captain America: The Winter Soldier,7.7,2014,170000000,714766572,544766572,Vista,128
271110,Capitán América: Civil War,Captain America: Civil War,7.4,2016,250000000,1153296293,903296293,Vista,147
228150,Corazones de acero,Fury,7.5,2014,68000000,211817906,143817906,Vista,134
312221,Creed. La leyenda de Rocky,Creed,7.4,2015,37000000,173567581,136567581,Vista,132
480530,Creed II: la leyenda de Rocky,Creed II,6.9,2018,50000000,214215889,164215889,Vista,120
293660,Deadpool,Deadpool,7.6,2016,58000000,783100000,725100000,Vista,109
383498,Deadpool 2,Deadpool 2,7.5,2018,110000000,741547413,631547413,Vista,120
9737,Dos policías rebeldes,Bad Boys,6.8,1995,19000000,141407024,122407024,Vista,118
8961,Dos policías rebeldes II,Bad Boys II,6.6,2003,130000000,273339556,143339556,Vista,147
38700,Bad Boys for Life,Bad Boys for Life,7.2,2020,90000000,426505244,336505244,Vista,123
155,El caballero oscuro,The Dark Knight,8.5,2008,185000000,1004558444,819558444,Vista,152
49026,El caballero oscuro: La leyenda renace,The Dark Knight Rises,7.7,2012,250000000,1081041287,831041287,Vista,165
272,Batman Begins,Batman Begins,7.7,2005,150000000,374218673,224218673,Vista,140
193756,El único superviviente,Lone Survivor,7.4,2013,40000000,149295601,109295601,Vista,121
390043,El otro guardaespaldas,The Hitman's Bodyguard,6.8,2017,30000000,176586701,146586701,Vista,120
245891,John Wick (Otro día para matar),John Wick,7.3,2014,20000000,88761661,68761661,Vista,101
324552,John Wick: Pacto de sangre,John Wick: Chapter 2,7.2,2017,40000000,171539887,131539887,Vista,122
458156,John Wick: Capítulo 3 - Parabellum,John Wick: Chapter 3 - Parabellum,7.4,2019,55000000,326709727,271709727,Vista,131
8247,Jumper,Jumper,6.1,2008,85000000,222231186,137231186,Vista,85
263115,Logan,Logan,7.8,2017,97000000,619021436,522021436,Vista,137
76170,Lobezno inmortal,The Wolverine,6.4,2013,120000000,415440673,295440673,Vista,126
333484,Los siete magníficos,The Magnificent Seven,6.3,2016,90000000,162360636,72360636,Vista,132
324857,Spider-Man: Un nuevo universo,Spider-Man: Into the Spider-Verse,8.4,2018,90000000,375540831,285540831,Vista,117
522627,The Gentlemen: Los señores de la mafia,The Gentlemen,7.7,2019,22000000,114996853,92996853,Vista,110
447332,Un lugar tranquilo,A Quiet Place,7.3,2018,17000000,340677200,323677200,Vista,95
24428,Los Vengadores,The Avengers,7.7,2012,220000000,1519557910,1299557910,Vista,143
99861,Vengadores: La era de Ultrón,Avengers: Age of Ultron,7.3,2015,250000000,1405403694,1155403694,Vista,140
299536,Vengadores: Infinity War,Avengers: Infinity War,8.3,2018,300000000,2046239637,1746239637,Vista,156
299534,Vengadores: Endgame,Avengers: Endgame,8.3,2019,356000000,2797800564,2441800564,Vista,181
16996,17 otra vez,17 Again,6.2,2009,20000000,136267476,116267476,Vista,102
452507,1922,1922,5.9,2017,0,0,0,Pendiente,101
470,21 gramos,21 Grams,7.3,2003,20000000,60427839,40427839,Pendiente,124
474354,22 de julio,22 July,7.2,2018,20000000,0,-20000000,Pendiente,143
170,28 días después,28 Days Later,7.2,2002,5000000,85720385,80720385,Pendiente,113
1562,28 semanas después,28 Weeks Later,6.6,2007,15000000,65048678,50048678,Pendiente,96
192102,3 días para matar,3 Days to Kill,6.1,2014,28000000,52597999,24597999,Pendiente,117
4513,30 días de oscuridad,30 Days of Night,6.3,2007,30000000,75505973,45505973,Pendiente,113
42941,30 días de oscuridad 2: Tinieblas,30 Days of Night: Dark Days,4.9,2010,0,0,0,Pendiente,92
109410,42,42,7.1,2013,40000000,95020213,55020213,Pendiente,128
17622,50 hombres muertos,Fifty Dead Men Walking,6.4,2008,10000000,997921,-9002079,Pendiente,117
347984,6 días,6 Days,6.0,2017,1500000,317072,-1182928,Pendiente,95
65,8 millas,8 Mile,7.1,2002,41000000,242875078,201875078,Pendiente,110
283235,99 Homes,99 Homes,6.8,2014,8000000,1411927,-6588073,Pendiente,112
8329,[•REC],[REC],7.1,2007,1500000,32511655,31011655,Vista,85
10664,[•REC]²,[REC]²,6.6,2009,5600000,18469680,12869680,Vista,85
80280,[•REC]³: Génesis,[REC]³ Génesis,5.1,2012,6400000,11019975,4619975,Vista,80
185341,[•REC]⁴: Apocalipsis,[REC] 4: Apocalipsis,5.5,2014,3000000,4915757,1915757,Pendiente,96
403119,A 47 metros,47 Meters Down,5.8,2017,5500000,44235023,38735023,Vista,87
405774,A ciegas,Bird Box,6.9,2018,19800000,0,-19800000,Vista,124
9799,A todo gas,The Fast and the Furious,6.9,2001,38000000,207283925,169283925,Vista,109
72331,Abraham Lincoln: cazador de vampiros,Abraham Lincoln: Vampire Hunter,5.6,2012,69000000,116471580,47471580,Vista,105
3049,Ace Ventura: un detective diferente,Ace Ventura: Pet Detective,6.5,1994,15000000,107217396,92217396,Vista,86
9273,Ace Ventura: operación África,Ace Ventura: When Nature Calls,6.3,1995,30000000,212385533,182385533,Vista,94
39254,Acero puro,Real Steel,6.9,2011,110000000,299268508,189268508,Vista,126
75674,Acto de valor,Act of Valor,6.3,2012,12000000,81272766,69272766,Vista,111
11638,Adivina quién,Guess Who,5.9,2005,35000000,68915888,33915888,Vista,106
9788,Admitido,Accepted,6.3,2006,23000000,38505009,15505009,Vista,90
172457,Afterparty,Afterparty,4.4,2013,0,75812,75812,Vista,78
37136,Agárralo como puedas,The Naked Gun: From the Files of Police Squad!,7.2,1988,12000000,78756177,66756177,Vista,86
37137,Agárralo como puedas 2 1/2: el aroma del miedo,The Naked Gun 2½: The Smell of Fear,6.8,1991,23000000,86930411,63930411,Vista,85
36593,Agárralo como puedas 33 1/3: el insulto final,Naked Gun 33⅓: The Final Insult,6.5,1994,30000000,51132598,21132598,Vista,83
39451,Ahora los padres son ellos,Little Fockers,5.6,2010,100000000,310650585,210650585,Vista,98
75656,Ahora me ves,Now You See Me,7.4,2013,75000000,351723989,276723989,Vista,115
291805,Ahora me ves 2,Now You See Me 2,6.8,2016,90000000,334901337,244901337,Vista,115
300601,Ahora o nunca,Ahora o nunca,5.5,2015,0,9456067,9456067,Vista,91
9772,Air Force One (El avión del presidente),Air Force One,6.4,1997,85000000,315156409,230156409,Vista,124
49527,Al borde del abismo,Man on a Ledge,6.4,2012,42000000,46221189,4221189,Vista,102
1636,Al diablo con el diablo,Bedazzled,5.9,2000,48000000,90383208,42383208,Vista,80
137113,Al filo del mañana,Edge of Tomorrow,7.6,2014,178000000,370541256,192541256,Vista,113
12201,Al límite,Edge of Darkness,6.3,2010,80000000,81126522,1126522,Vista,117
420817,Aladdín,Aladdin,7.1,2019,183000000,1047612394,864612394,Vista,128
812,Aladdín,Aladdin,7.6,1992,28000000,504050219,476050219,Vista,87
11238,Aladdín y el rey de los ladrones,Aladdin and the King of Thieves,6.2,1996,0,0,0,Vista,80
1966,Alejandro Magno,Alexander,5.9,2004,155000000,167298192,12298192,Vista,173
49022,Algo prestado,Something Borrowed,6.2,2011,35000000,65090821,30090821,Vista,112
395,Alien vs. Predator,AVP: Alien vs. Predator,5.8,2004,70000000,177427090,107427090,Vista,100
440,Aliens vs. Predator 2,Aliens vs Predator: Requiem,5.0,2007,40000000,130290885,90290885,Vista,87
126889,Alien: Covenant,Alien: Covenant,6.0,2017,97000000,232380243,135380243,Vista,122
924,Amanecer de los muertos,Dawn of the Dead,7.0,2004,28000000,102356381,74356381,Vista,101
415842,American Assassin,American Assassin,6.3,2017,33000000,66167951,33167951,Vista,115
73,American History X,American History X,8.4,1998,20000000,23875127,3875127,Vista,119
2105,American Pie,American Pie,6.5,1999,11000000,235483004,224483004,Vista,95
2770,American Pie 2,American Pie 2,6.2,2001,30000000,287553595,257553595,Vista,108
26123,American Pie presenta: El libro del amor,American Pie Presents: The Book of Love,5.3,2009,7000000,5021219,-1978781,Vista,93
8275,American Pie presenta: Una fiesta de pelotas,American Pie Presents: The Naked Mile,5.5,2006,15000000,27500000,12500000,Vista,97
71552,American Pie: El reencuentro,American Reunion,6.2,2012,50000000,234989584,184989584,Vista,113
1359,American Psycho,American Psycho,7.3,2000,7000000,34266564,27266564,Vista,102
261392,American Ultra,American Ultra,6.1,2015,28000000,27139524,-860476,Vista,96
79711,Amigos...,Amigos...,5.6,2011,3031875,2425500,-606375,Vista,92
9889,Amor ciego,Shallow Hal,6.1,2001,40000000,141069860,101069860,Vista,113
238636,Anarchy: La noche de las bestias,The Purge: Anarchy,6.7,2014,9000000,111928365,102928365,Vista,100
9444,Anastasia,Anastasia,7.6,1997,53000000,139804348,86804348,Vista,94
259316,Animales fantásticos y dónde encontrarlos,Fantastic Beasts and Where to Find Them,7.4,2016,180000000,809342332,629342332,Vista,133
338952,Animales fantásticos: los crímenes de Grindelwald,Fantastic Beasts: The Crimes of Grindelwald,6.9,2018,200000000,653355901,453355901,Vista,134
300668,Aniquilación,Annihilation,6.3,2018,40000000,43070915,3070915,Vista,115
250546,Annabelle,Annabelle,5.7,2014,6500000,257047661,250547661,Vista,98
102899,Ant-Man,Ant-Man,7.1,2015,130000000,519311965,389311965,Vista,117
363088,Ant-Man y la Avispa,Ant-Man and the Wasp,7.0,2018,140000000,622674139,482674139,Vista,138
8916,Antz (Hormigaz),Antz,6.1,1998,60000000,171757863,111757863,Vista,83
297802,Aquaman,Aquaman,6.9,2018,160000000,1148461807,988461807,Vista,142
68734,Argo,Argo,7.3,2012,44500000,232324128,187824128,Vista,120
95,Armageddon,Armageddon,6.8,1998,140000000,553799566,413799566,Vista,150
16871,Arrástrame al infierno,Drag Me to Hell,6.3,2009,30000000,90810892,60810892,Vista,99
117251,Asalto al poder,White House Down,6.4,2013,150000000,205366737,55366737,Vista,131
18487,Asalto al tren Pelham 123,The Taking of Pelham 1 2 3,6.3,2009,100000000,150166126,50166126,Vista,106
13389,Asesinato justo,Righteous Kill,5.9,2008,60000000,79498846,19498846,Vista,100
121856,Assassin's Creed,Assassin's Creed,5.4,2016,125000000,240697856,115697856,Vista,115
9564,Astérix y Obélix contra César,Astérix & Obélix contre César,6.0,1999,0,1644060,1644060,Vista,115
2899,Astérix y Obélix: Misión Cleopatra,Astérix & Obélix Mission Cléopâtre,7.4,2002,58500000,111127553,52627553,Vista,107
207933,Asylum: El experimento,Stonehearst Asylum,6.7,2014,0,2478806,2478806,Vista,112
256274,Así en la tierra como en el infierno,As Above So Below,6.6,2014,5000000,40100000,35100000,Vista,93
813,Aterriza como puedas,Airplane!,7.3,1980,3500000,83453539,79953539,Vista,88
10865,Atlantis: El imperio perdido,Atlantis: The Lost Empire,6.9,2001,120000000,186053725,66053725,Vista,95
137,Atrapado en el tiempo,Groundhog Day,7.6,1993,14600000,70906973,56306973,Vista,101
93856,Atrapados en Chernóbil,Chernobyl Diaries,5.1,2012,1000000,38390020,37390020,Vista,90
6972,Australia,Australia,6.6,2008,130000000,211787511,81787511,Vista,165
19995,Avatar,Avatar,7.5,2009,237000000,2787965087,2550965087,Vista,161
495764,Aves de presa (y la fantabulosa emancipación de Harley Quinn),Birds of Prey (and the Fantabulous Emancipation of One Harley Quinn),7.1,2020,75000000,201858461,126858461,Vista,109
480105,A 47 metros 2: El terror emerge,47 Meters Down: Uncaged,5.7,2019,12000000,47582563,35582563,Pendiente,90
297762,Wonder Woman,Wonder Woman,7.3,2017,149000000,821847012,672847012,Vista,141
597,Titanic,Titanic,7.9,1997,200000000,2187463944,1987463944,Vista,187
140607,Star Wars: El despertar de la fuerza,Star Wars: The Force Awakens,7.4,2015,245000000,2068223624,1823223624,Vista,136
135397,Jurassic World,Jurassic World,6.6,2015,150000000,1671713208,1521713208,Vista,124
351286,Jurassic World: El reino caído,Jurassic World: Fallen Kingdom,6.6,2018,170000000,1303459585,1133459585,Vista,128
420818,El Rey León,The Lion King,7.2,2019,260000000,1656943394,1396943394,Vista,118
168259,Fast & Furious 7,Furious 7,7.3,2015,190000000,1515047671,1325047671,Vista,137
109445,Frozen: El reino del hielo,Frozen,7.3,2013,150000000,1274219009,1124219009,Vista,102
284054,Black Panther,Black Panther,7.4,2018,200000000,1346739107,1146739107,Vista,134
330457,Frozen 2,Frozen II,7.3,2019,150000000,1450026933,1300026933,Pendiente,103
12444,Harry Potter y las Reliquias de la Muerte - Parte 1,Harry Potter and the Deathly Hallows: Part 1,7.8,2010,250000000,954305868,704305868,Vista,146
12445,Harry Potter y las Reliquias de la Muerte - Parte 2,Harry Potter and the Deathly Hallows: Part 2,8.1,2011,125000000,1341511219,1216511219,Vista,130
181808,Star Wars: Los últimos Jedi,Star Wars: The Last Jedi,6.9,2017,200000000,1332539889,1132539889,Vista,151
321612,La bella y la bestia,Beauty and the Beast,7.0,2017,160000000,1263521126,1103521126,Vista,129
9806,Los Increíbles,The Incredibles,7.7,2004,92000000,631442092,539442092,Vista,115
260513,Los Increíbles 2,Incredibles 2,7.5,2018,200000000,1242805359,1042805359,Vista,120
337339,Fast & Furious 8,The Fate of the Furious,6.9,2017,250000000,1238764765,988764765,Vista,136
1726,Iron Man,Iron Man,7.6,2008,140000000,585174222,445174222,Vista,126
10138,Iron Man 2,Iron Man 2,6.8,2010,200000000,623933331,423933331,Vista,125
68721,Iron Man 3,Iron Man 3,6.9,2013,200000000,1214811252,1014811252,Vista,130
557,Spider-Man,Spider-Man,7.2,2002,139000000,821708551,682708551,Vista,121
558,Spider-Man 2,Spider-Man 2,7.1,2004,200000000,783766341,583766341,Vista,136
559,Spider-Man 3,Spider-Man 3,6.2,2007,258000000,890871626,632871626,Vista,139
1930,The Amazing Spider-Man,The Amazing Spider-Man,6.6,2012,215000000,757930663,542930663,Vista,136
102382,The Amazing Spider-Man 2: El poder de Electro,The Amazing Spider-Man 2,6.4,2014,200000000,708962323,508962323,Vista,142
315635,Spider-Man: Homecoming,Spider-Man: Homecoming,7.4,2017,175000000,880166924,705166924,Vista,110
429617,Spider-Man: Lejos de casa,Spider-Man: Far from Home,7.5,2019,160000000,1131927996,971927996,Vista,135
299537,Capitana Marvel,Captain Marvel,7.0,2019,152000000,1128276090,976276090,Vista,125
335988,Transformers: El último caballero,Transformers: The Last Knight,6.0,2017,217000000,605425157,388425157,Vista,154
91314,Transformers: La era de la extinción,Transformers: Age of Extinction,5.9,2014,210000000,1104054072,894054072,Vista,165
1858,Transformers,Transformers,6.7,2007,150000000,709709780,559709780,Vista,144
8373,Transformers: La venganza de los caídos,Transformers: Revenge of the Fallen,6.1,2009,200000000,836303693,636303693,Vista,150
38356,Transformers: El lado oscuro de la Luna,Transformers: Dark of the Moon,6.1,2011,195000000,1123794079,928794079,Vista,154
120,El señor de los anillos: La comunidad del anillo,The Lord of the Rings: The Fellowship of the Ring,8.3,2001,93000000,871368364,778368364,Vista,179
121,El señor de los anillos: Las dos torres,The Lord of the Rings: The Two Towers,8.3,2002,79000000,926287400,847287400,Vista,180
122,El señor de los anillos: El retorno del rey,The Lord of the Rings: The Return of the King,8.5,2003,94000000,1118888979,1024888979,Vista,202
37724,Skyfall,Skyfall,7.2,2012,200000000,1108561013,908561013,Vista,143
475557,Joker,Joker,8.2,2019,55000000,1074251311,1019251311,Vista,122
181812,Star Wars: El ascenso de Skywalker,Star Wars: The Rise of Skywalker,6.5,2019,250000000,1074144248,824144248,Vista,142
862,Toy Story,Toy Story,7.9,1995,30000000,373554033,343554033,Vista,77
863,Toy Story 2,Toy Story 2,7.6,1999,90000000,497366869,407366869,Vista,93
10193,Toy Story 3,Toy Story 3,7.8,2010,200000000,1066969703,866969703,Vista,100
301528,Toy Story 4,Toy Story 4,7.6,2019,175000000,1073394593,898394593,Vista,90
22,Piratas del Caribe. La maldición de la Perla Negra,Pirates of the Caribbean: The Curse of the Black Pearl,7.7,2003,140000000,655011224,515011224,Vista,143
58,Piratas del Caribe: El cofre del hombre muerto,Pirates of the Caribbean: Dead Man's Chest,7.3,2006,200000000,1065659812,865659812,Vista,151
285,Piratas del Caribe: En el fin del mundo,Pirates of the Caribbean: At World's End,7.2,2007,300000000,961000000,661000000,Vista,168
166426,Piratas del Caribe: La venganza de Salazar,Pirates of the Caribbean: Dead Men Tell No Tales,6.6,2017,230000000,794861794,564861794,Vista,129
1865,Piratas del Caribe: En mareas misteriosas,Pirates of the Caribbean: On Stranger Tides,6.5,2011,380000000,1045713802,665713802,Pendiente,141
330459,Rogue One: Una historia de Star Wars,Rogue One: A Star Wars Story,7.5,2016,200000000,1056057273,856057273,Vista,133
329,Jurassic Park (Parque Jurásico),Jurassic Park,7.9,1993,63000000,920100000,857100000,Vista,120
330,El mundo perdido: Jurassic Park,The Lost World: Jurassic Park,6.5,1997,73000000,618638999,545638999,Vista,128
331,Jurassic Park III (Parque Jurásico III),Jurassic Park III,6.1,2001,93000000,368780809,275780809,Vista,92
127380,Buscando a Dory,Finding Dory,7.0,2016,200000000,1028570889,828570889,Vista,97
12,Buscando a Nemo,Finding Nemo,7.8,2003,94000000,940335536,846335536,Vista,101
1893,La guerra de las galaxias. Episodio I: La amenaza fantasma,Star Wars: Episode I - The Phantom Menace,6.5,1999,115000000,924317558,809317558,Vista,131
1894,La guerra de las galaxias. Episodio II: El ataque de los clones,Star Wars: Episode II - Attack of the Clones,6.5,2002,120000000,649398328,529398328,Vista,132
1895,La guerra de las galaxias. Episodio III: La venganza de los Sith,Star Wars: Episode III - Revenge of the Sith,7.3,2005,113000000,850000000,737000000,Vista,140
49051,El hobbit: Un viaje inesperado,The Hobbit: An Unexpected Journey,7.3,2012,250000000,1021103568,771103568,Vista,169
57158,El hobbit: La desolación de Smaug,The Hobbit: The Desolation of Smaug,7.6,2013,250000000,958400000,708400000,Vista,170
122917,El hobbit: La batalla de los cinco ejércitos,The Hobbit: The Battle of the Five Armies,7.3,2014,250000000,956019788,706019788,Vista,144
671,Harry Potter y la piedra filosofal,Harry Potter and the Philosopher's Stone,7.9,2001,125000000,976475550,851475550,Vista,152
672,Harry Potter y la cámara secreta,Harry Potter and the Chamber of Secrets,7.7,2002,100000000,876688482,776688482,Vista,150
673,Harry Potter y el prisionero de Azkaban,Harry Potter and the Prisoner of Azkaban,8.0,2004,130000000,789804554,659804554,Vista,141
674,Harry Potter y el cáliz de fuego,Harry Potter and the Goblet of Fire,7.8,2005,150000000,895921036,745921036,Vista,157
675,Harry Potter y la Orden del Fénix,Harry Potter and the Order of the Phoenix,7.7,2007,150000000,938212738,788212738,Vista,138
767,Harry Potter y el misterio del príncipe,Harry Potter and the Half-Blood Prince,7.7,2009,250000000,933959197,683959197,Vista,153
278927,El libro de la selva,The Jungle Book,6.8,2016,175000000,966550600,791550600,Vista,105
8844,Jumanji,Jumanji,7.2,1995,65000000,262797249,197797249,Vista,104
353486,Jumanji: Bienvenidos a la jungla,Jumanji: Welcome to the Jungle,6.8,2017,90000000,962102237,872102237,Vista,119
512200,Jumanji: siguiente nivel,Jumanji: The Next Level,7.0,2019,125000000,796575993,671575993,Vista,125
27205,Origen,Inception,8.3,2010,160000000,825532764,665532764,Vista,148
808,Shrek,Shrek,7.6,2001,60000000,484409218,424409218,Vista,92
809,Shrek 2,Shrek 2,7.1,2004,150000000,928760770,778760770,Vista,92
810,Shrek Tercero,Shrek the Third,6.2,2007,160000000,798958165,638958165,Vista,92
10192,Shrek: felices para siempre,Shrek Forever After,6.2,2010,165000000,752600867,587600867,Vista,93
424694,Bohemian Rhapsody,Bohemian Rhapsody,8.0,2018,52000000,894027543,842027543,Vista,134
425,Ice Age: La edad de hielo,Ice Age,7.3,2002,59000000,383257136,324257136,Vista,75
950,Ice Age 2: El deshielo,Ice Age: The Meltdown,6.6,2006,80000000,660998756,580998756,Vista,91
209112,Batman v. Superman: El amanecer de la Justicia,Batman v Superman: Dawn of Justice,5.9,2016,250000000,873634919,623634919,Vista,153
10195,Thor,Thor,6.8,2011,150000000,449326618,299326618,Vista,115
76338,Thor: el mundo oscuro,Thor: The Dark World,6.6,2013,170000000,644571402,474571402,Vista,112
284053,Thor: Ragnarok,Thor: Ragnarok,7.6,2017,180000000,853977126,673977126,Vista,131
118340,Guardianes de la galaxia,Guardians of the Galaxy,7.9,2014,170000000,772776600,602776600,Vista,122
283995,Guardianes de la galaxia Vol. 2,Guardians of the Galaxy Vol. 2,7.6,2017,200000000,863756051,663756051,Vista,137
150540,Del revés,Inside Out,7.9,2015,175000000,857611174,682611174,Vista,95
335983,Venom,Venom,6.8,2018,116000000,855013954,739013954,Vista,112
47933,Independence Day: Contraataque,Independence Day: Resurgence,5.2,2016,165000000,389681935,224681935,Vista,120
602,Independence Day,Independence Day,6.8,1996,75000000,817400891,742400891,Vista,145
354912,Coco,Coco,8.2,2017,175000000,800526015,625526015,Vista,109
954,Misión imposible,Mission: Impossible,6.9,1996,80000000,457731198,377731198,Vista,110
955,Misión imposible 2,Mission: Impossible II,6.1,2000,125000000,546388105,421388105,Vista,123
956,Misión imposible 3,Mission: Impossible III,6.7,2006,150000000,397850012,247850012,Vista,126
177677,Misión imposible: Nación secreta,Mission: Impossible - Rogue Nation,7.2,2015,150000000,682330139,532330139,Vista,131
56292,Misión imposible: Protocolo fantasma,Mission: Impossible - Ghost Protocol,7.0,2011,145000000,694713380,549713380,Vista,132
89,Indiana Jones y la última cruzada,Indiana Jones and the Last Crusade,7.8,1989,48000000,474171806,426171806,Vista,127
87,Indiana Jones y el templo maldito,Indiana Jones and the Temple of Doom,7.3,1984,28000000,333000000,305000000,Vista,118
217,Indiana Jones y el reino de la calavera de cristal,Indiana Jones and the Kingdom of the Crystal Skull,5.9,2008,185000000,786636033,601636033,Vista,123
85,En busca del arca perdida,Raiders of the Lost Ark,7.9,1981,18000000,389925971,371925971,Vista,115
601,E.T. el extraterrestre,E.T. the Extra-Terrestrial,7.5,1982,10500000,792965500,782465500,Vista,115
384018,Fast & Furious: Hobbs & Shaw,Fast & Furious Presents: Hobbs & Shaw,6.9,2019,200000000,760098996,560098996,Vista,137
591,El código Da Vinci,The Da Vinci Code,6.7,2006,125000000,767820459,642820459,Vista,149
13448,Ángeles y demonios,Angels & Demons,6.7,2009,150000000,356613439,206613439,Vista,138
207932,Inferno,Inferno,6.0,2016,75000000,220021259,145021259,Vista,121
258489,La leyenda de Tarzán,The Legend of Tarzan,5.8,2016,180000000,356743061,176743061,Vista,110
380,Rain Man,Rain Man,7.8,1988,25000000,354825435,329825435,Pendiente,133
744,Top Gun,Top Gun,6.9,1986,15000000,356830601,341830601,Vista,110
8338,A ciegas,Blindness,6.5,2008,25000000,19844979,-5155021,Pendiente,118
2116,A contrarreloj,Out of Time,6.3,2003,50000000,55495563,5495563,Pendiente,114
755,Abierto hasta el amanecer,From Dusk Till Dawn,7.0,1996,19000000,25836616,6836616,Pendiente,110
1368,Acorralado,First Blood,7.4,1982,15000000,125212904,110212904,Pendiente,93
419704,Ad astra,Ad Astra,6.1,2019,87500000,132807427,45307427,Pendiente,123
552178,Aguas oscuras,Dark Waters,7.5,2019,0,23601384,23601384,Pendiente,127
7350,Ahora o nunca,The Bucket List,7.2,2007,45000000,175372502,130372502,Pendiente,96
239678,Ahí os quedáis,This Is Where I Leave You,6.6,2014,19800000,41296320,21496320,Pendiente,103
1537,Al límite de la verdad,Changing Lanes,6.1,2002,45000000,94935764,49935764,Pendiente,99
369885,Aliados,Allied,6.7,2016,85000000,119520023,34520023,Pendiente,124
8078,Alien: Resurrección,Alien Resurrection,6.1,1997,70000000,162000000,92000000,Pendiente,109
679,Aliens: El regreso,Aliens,7.9,1986,18500000,183316455,164816455,Pendiente,137
8077,Alien³,Alien³,6.3,1992,50000000,159773545,109773545,Pendiente,114
399579,Alita: Ángel de combate,Alita: Battle Angel,7.1,2019,170000000,404852543,234852543,Pendiente,122
43931,Almas condenadas,My Soul to Take,5.4,2010,25000000,19829957,-5170043,Pendiente,107
7457,Alpha Dog,Alpha Dog,6.7,2006,0,15309302,15309302,Pendiente,117
8489,Alí,Ali,6.8,2001,107000000,87713825,-19286175,Pendiente,167
38199,Amenazados,Unthinkable,6.6,2010,15000000,5483534,-9516466,Pendiente,97
4982,American Gangster,American Gangster,7.6,2007,100000000,266465037,166465037,Pendiente,157
203835,Amityville: El despertar,Amityville: The Awakening,5.4,2017,0,7701908,7701908,Pendiente,85
284514,Anacleto: agente secreto,Anacleto: Agente secreto,5.8,2015,2182950,3020332,837382,Pendiente,87
353979,Animal de compañía,Pet,5.8,2016,0,22003,22003,Pendiente,94
340666,Animales nocturnos,Nocturnal Animals,7.5,2016,22500000,29252978,6752978,Pendiente,115
521029,Annabelle vuelve a casa,Annabelle Comes Home,6.4,2019,30000000,231252591,201252591,Pendiente,115
396422,Annabelle: Creation,Annabelle: Creation,6.6,2017,15000000,306515884,291515884,Pendiente,109
640146,Ant-Man y la Avispa: Quantumania,Ant-Man and the Wasp: Quantumania,0.0,2022,0,0,0,Pendiente,0
464052,Wonder Woman 1984,Wonder Woman 1984,7.0,2020,200000000,157087000,-42913000,Vista,151
524047,Greenland: El último refugio,Greenland,7.2,2020,34000000,47800000,13800000,Vista,120
399566,Godzilla vs Kong,Godzilla vs. Kong,0.0,2021,155000000,0,-155000000,Pendiente,0
373571,Godzilla: Rey de los Monstruos,Godzilla: King of the Monsters,6.6,2019,170000000,386600138,216600138,Vista,132
929,Godzilla,Godzilla,5.6,1998,130000000,379014294,249014294,Vista,138
124905,Godzilla,Godzilla,6.2,2014,160000000,529076069,369076069,Vista,123
293167,Kong: La isla calavera,Kong: Skull Island,6.4,2017,185000000,566652812,381652812,Vista,118
254,King Kong,King Kong,6.8,2005,207000000,562363449,355363449,Vista,180
522681,Escape Room,Escape Room,6.4,2019,9000000,155313078,146313078,Vista,100
502416,El sótano de Ma,Ma,5.8,2019,5000000,51749995,46749995,Vista,105
546554,Puñales por la espalda,Knives Out,7.8,2019,40000000,309232797,269232797,Vista,130
490132,Green Book,Green Book,8.3,2018,23000000,319700000,296700000,Vista,130
419430,Déjame salir,Get Out,7.6,2017,4500000,255407969,250907969,Vista,103
274870,Passengers,Passengers,6.9,2016,110000000,303144152,193144152,Vista,116
466272,Érase una vez en… Hollywood,Once Upon a Time… in Hollywood,7.5,2019,95000000,374251247,279251247,Pendiente,162
316029,El gran showman,The Greatest Showman,8.0,2017,84000000,432844677,348844677,Vista,105
346364,It,It,7.2,2017,35000000,701796444,666796444,Vista,135
474350,It: Capítulo 2,It Chapter Two,6.9,2019,79000000,473093228,394093228,Vista,169
78,Blade Runner,Blade Runner,7.9,1982,28000000,41670166,13670166,Pendiente,117
335984,Blade Runner 2049,Blade Runner 2049,7.5,2017,150000000,259239658,109239658,Pendiente,164
577922,Tenet,Tenet,7.3,2020,205000000,363129000,158129000,Vista,155
340102,Los nuevos mutantes,The New Mutants,6.4,2020,67000000,45534613,-21465387,Vista,94
278,Cadena perpetua,The Shawshank Redemption,8.7,1994,25000000,28341469,3341469,Pendiente,143
424,La lista de Schindler,Schindler's List,8.6,1993,22000000,321365567,299365567,Vista,195
496243,Parásitos,기생충,8.5,2019,11363000,257591776,246228776,Pendiente,132
497,La milla verde,The Green Mile,8.5,1999,60000000,286801374,226801374,Pendiente,189
680,Pulp Fiction,Pulp Fiction,8.5,1994,8000000,214179088,206179088,Pendiente,154
637,La vida es bella,La vita è bella,8.5,1997,20000000,229400000,209400000,Vista,117
13,Forrest Gump,Forrest Gump,8.5,1994,55000000,677387716,622387716,Pendiente,142
311,Érase una vez en América,Once Upon a Time in America,8.5,1984,20000000,5472914,-14527086,Pendiente,225
769,Uno de los nuestros,GoodFellas,8.4,1990,25000000,46835000,21835000,Pendiente,146
550,El club de la lucha,Fight Club,8.4,1999,63000000,100853753,37853753,Vista,139
141052,Liga de la Justicia,Justice League,6.2,2017,300000000,657924295,357924295,Vista,121
618344,Justice League Dark: Apokolips War,Justice League Dark: Apokolips War,8.4,2020,0,0,0,Vista,90
244786,Whiplash,Whiplash,8.4,2014,3300000,13092000,9792000,Pendiente,105
423,El pianista,The Pianist,8.4,2002,35000000,120072577,85072577,Pendiente,150
807,Seven,Se7en,8.3,1995,33000000,327311859,294311859,Vista,127
157336,Interestelar,Interstellar,8.3,2014,165000000,675120017,510120017,Vista,169
105,Regreso al futuro,Back to the Future,8.3,1985,19000000,381109762,362109762,Pendiente,116
165,Regreso al futuro II,Back to the Future Part II,7.7,1989,40000000,332000000,292000000,Pendiente,105
196,Regreso al futuro III,Back to the Future Part III,7.4,1990,40000000,244527583,204527583,Pendiente,118
77338,Intocable,Intouchables,8.2,2011,13000000,426588510,413588510,Vista,112
8587,El rey león,The Lion King,8.2,1994,45000000,763455561,718455561,Vista,85
9732,El rey león 2: El tesoro de Simba,The Lion King II: Simba's Pride,7.0,1998,0,0,0,Vista,80
7972,Antes que el diablo sepa que has muerto,Before the Devil Knows You're Dead,7.1,2007,18000000,25005257,7005257,Pendiente,116
516329,Antlers,Antlers,0.0,2021,0,0,0,Pendiente,99
50357,Apollo 18,Apollo 18,5.2,2011,5000000,25562924,20562924,Pendiente,88
549559,Apolo 11,Apollo 11,8.0,2019,0,0,0,Pendiente,90
568,Apolo 13,Apollo 13,7.4,1995,52000000,355237933,303237933,Pendiente,140
12690,Appaloosa,Appaloosa,6.6,2008,20000000,20211394,211394,Pendiente,107
11635,Aquellas juergas universitarias,Old School,6.6,2003,24000000,87135520,63135520,Pendiente,91
410199,Arq,ARQ,6.1,2016,2000000,0,-2000000,Pendiente,88
11517,Asalto al tren del dinero,Money Train,5.8,1995,68000000,77224232,9224232,Pendiente,110
242224,Babadook,The Babadook,6.5,2014,2000000,10312540,8312540,Vista,95
339403,Baby Driver,Baby Driver,7.5,2017,34000000,226945087,192945087,Vista,115
118957,Bait (Carnada),Bait,5.6,2012,30000000,32500000,2500000,Vista,93
9036,Bajo cero,Eight Below,7.0,2006,40000000,120455994,80455994,Vista,120
555657,Bajo el mismo techo,Bajo el mismo techo,5.3,2019,0,4101562,4101562,Vista,97
56812,Balada triste de trompeta,Balada triste de trompeta,6.7,2010,7000000,3604598,-3395402,Vista,101
21032,Balto: la leyenda del perro esquimal,Balto,7.3,1995,31000000,11348324,-19651676,Vista,77
414,Batman Forever,Batman Forever,5.4,1995,100000000,336529144,236529144,Vista,121
485942,Batman Ninja,ニンジャバットマン,5.8,2018,0,0,0,Vista,85
321528,Batman vs Robin,Batman vs. Robin,7.2,2015,0,0,0,Vista,80
408648,Batman y Harley Quinn,Batman and Harley Quinn,6.1,2017,3500000,0,-3500000,Vista,74
40662,Batman: El Misterio de Capucha Roja,Batman: Under the Red Hood,7.8,2010,0,6629178,6629178,Vista,75
123025,Batman: El regreso del Caballero Oscuro (Parte 1),Batman: The Dark Knight Returns (Part 1),7.8,2012,3500000,0,-3500000,Vista,76
142061,Batman: El regreso del Caballero Oscuro (Parte 2),Batman: The Dark Knight Returns (Part 2),7.9,2013,3500000,0,-3500000,Vista,78
471474,Batman: Gotham a Luz de Gas,Batman: Gotham by Gaslight,6.6,2018,1000000,3469151,2469151,Vista,78
537056,Batman: Hush,Batman: Hush,7.3,2019,0,0,0,Vista,82
382322,Batman: La broma asesina,Batman: The Killing Joke,6.6,2016,3500000,3775000,275000,Vista,72
324849,Batman: La LEGO película,The Lego Batman Movie,7.2,2017,80000000,311950384,231950384,Vista,105
14919,Batman: La máscara del fantasma,Batman: Mask of the Phantasm,7.5,1993,6000000,5617391,-382609,Vista,76
366924,Batman: Mala sangre,Batman: Bad Blood,7.1,2016,3500000,0,-3500000,Vista,75
15805,Batman: Subzero,Batman & Mr. Freeze: SubZero,7.0,1998,0,0,0,Vista,70
44833,Battleship,Battleship,5.7,2012,209000000,303025485,94025485,Vista,131
198277,Begin Again,Begin Again,7.3,2013,8000000,63464861,55464861,Vista,104
19908,Bienvenidos a Zombieland,Zombieland,7.3,2009,23600000,102391540,78791540,Vista,85
338967,Zombieland: Mata y remata,Zombieland: Double Tap,7.0,2019,42000000,122801777,80801777,Vista,99
177572,Big Hero 6,Big Hero 6,7.8,2014,165000000,657827828,492827828,Vista,101
71,Billy Elliot (Quiero bailar),Billy Elliot,7.6,2000,5000000,109280263,104280263,Vista,110
36647,Blade,Blade,6.7,1998,45000000,131183530,86183530,Vista,120
36586,Blade II,Blade II,6.4,2002,54000000,155010032,101010032,Vista,117
36648,Blade Trinity,Blade: Trinity,5.9,2004,65000000,128905366,63905366,Vista,123
351211,Blair Witch,Blair Witch,5.2,2016,5000000,45172994,40172994,Vista,89
338762,Bloodshot,Bloodshot,6.9,2020,42000000,33542457,-8457543,Vista,115
288171,Blue Mountain State: The Rise of Thadland,Blue Mountain State: The Rise of Thadland,5.6,2016,0,0,0,Vista,90
400106,Bright,Bright,6.2,2017,90000000,0,-90000000,Vista,120
8386,Buen rollito,How High,6.3,2001,12000000,31155435,19155435,Vista,95
424783,Bumblebee,Bumblebee,6.7,2018,135000000,467989645,332989645,Vista,114
333669,Asalto en París,Bastille Day,6.2,2016,20000000,14397593,-5602407,Pendiente,92
7516,Ases calientes,Smokin' Aces,6.5,2006,17000000,57103895,40103895,Pendiente,110
392044,Asesinato en el Orient Express,Murder on the Orient Express,6.7,2017,55000000,351839303,296839303,Pendiente,114
49021,Asesinos de élite,Killer Elite,6.2,2011,66000000,57777106,-8222894,Pendiente,105
98548,Así somos,People Like Us,6.7,2012,16000000,12434778,-3565222,Pendiente,114
10998,Atracción fatal,Fatal Attraction,6.8,1987,14000000,320145693,306145693,Pendiente,119
6075,Atrapado por su pasado,Carlito's Way,7.8,1993,30000000,63848322,33848322,Pendiente,144
640,Atrápame si puedes,Catch Me If You Can,7.9,2002,52000000,352114312,300114312,Pendiente,141
539885,Ava,Ava,5.6,2020,0,2987741,2987741,Pendiente,100
76600,Avatar 2,Avatar 2,0.0,2022,387000000,0,-387000000,Pendiente,0
83533,Avatar 3,Avatar 3,0.0,2024,0,0,0,Pendiente,0
216527,Avatar 4,Avatar 4,0.0,2026,0,0,0,Pendiente,0
393209,Avatar 5,Avatar 5,0.0,2028,0,0,0,Pendiente,0
3600,Aún sé lo que hicisteis el último verano,I Still Know What You Did Last Summer,5.3,1998,65000000,40002112,-24997888,Pendiente,100
332562,Ha nacido una estrella,A Star Is Born,7.5,2018,36000000,433888866,397888866,Pendiente,135
246655,X-Men: Apocalipsis,X-Men: Apocalypse,6.5,2016,178000000,543934787,365934787,Vista,144
127585,X-Men: Días del futuro pasado,X-Men: Days of Future Past,7.5,2014,250000000,747862775,497862775,Vista,130
2080,X-Men orígenes: Lobezno,X-Men Origins: Wolverine,6.2,2009,150000000,373062864,223062864,Vista,107
36657,X-Men,X-Men,7.0,2000,75000000,296339527,221339527,Vista,104
49538,X-Men: Primera Generación,X-Men: First Class,7.3,2011,160000000,353624124,193624124,Vista,131
36668,X-Men: La decisión final,X-Men: The Last Stand,6.4,2006,210000000,459359555,249359555,Vista,105
36658,X-Men 2,X2,7.0,2003,110000000,407711549,297711549,Vista,133
2501,The Bourne Identity: El caso Bourne,The Bourne Identity,7.4,2002,60000000,214034224,154034224,Vista,113
2502,El mito de Bourne,The Bourne Supremacy,7.3,2004,75000000,288500217,213500217,Vista,108
2503,El ultimátum de Bourne,The Bourne Ultimatum,7.4,2007,70000000,442824138,372824138,Vista,111
49040,El legado de Bourne,The Bourne Legacy,6.2,2012,130000000,276572938,146572938,Vista,135
324668,Jason Bourne,Jason Bourne,6.2,2016,120000000,415484914,295484914,Vista,123
581392,Península,반도,7.0,2020,17000000,39657073,22657073,Pendiente,116
72190,Guerra Mundial Z,World War Z,6.8,2013,200000000,531865000,331865000,Vista,116
857,Salvar al soldado Ryan,Saving Private Ryan,8.2,1998,70000000,481840909,411840909,Vista,169
111,El precio del poder,Scarface,8.2,1983,25000000,66023329,41023329,Pendiente,170
501170,Doctor Sueño,Doctor Sleep,7.1,2019,45000000,72281712,27281712,Vista,151
284052,Doctor Strange,Doctor Strange,7.4,2016,165000000,677700000,512700000,Vista,115
59961,El invitado,Safe House,6.4,2012,85000000,208076205,123076205,Vista,115
109428,Posesión infernal (Evil Dead),Evil Dead,6.4,2013,17000000,97542952,80542952,Vista,90
585,Monstruos S.A.,Monsters Inc.,7.8,2001,115000000,562816256,447816256,Vista,88
62211,Monstruos University,Monsters University,7.0,2013,200000000,743559607,543559607,Vista,102
1597,Los padres de ella,Meet the Parents,6.7,2000,55000000,330444045,275444045,Vista,107
693,Los padres de él,Meet the Fockers,6.2,2004,80000000,516642939,436642939,Vista,115
36557,Casino Royale,Casino Royale,7.5,2006,150000000,599045960,449045960,Vista,144
176,Saw,Saw,7.4,2004,1200000,103911669,102711669,Vista,102
215,Saw II,Saw II,6.6,2005,4000000,152925093,148925093,Vista,93
214,Saw III,Saw III,6.4,2006,10000000,163876815,153876815,Vista,114
663,Saw IV,Saw IV,6.2,2007,10000000,139352633,129352633,Vista,93
11917,Saw V,Saw V,6.2,2008,10800000,113857533,103057533,Vista,92
22804,Saw VI,Saw VI,6.3,2009,11000000,68233629,57233629,Vista,90
41439,Saw VII,Saw 3D,6.0,2010,20000000,136150434,116150434,Vista,90
602734,Spiral: Saw,Spiral: From the Book of Saw,0.0,2021,0,0,0,Pendiente,0
5915,Hacia rutas salvajes,Into the Wild,7.8,2007,15000000,56255142,41255142,Vista,140
13475,Star Trek,Star Trek,7.4,2009,150000000,385680446,235680446,Vista,127
54138,Star Trek: En la oscuridad,Star Trek Into Darkness,7.3,2013,190000000,467365246,277365246,Vista,132
188927,Star Trek: Más allá,Star Trek Beyond,6.8,2016,185000000,343471816,158471816,Vista,122
752,V de Vendetta,V for Vendetta,7.9,2006,54000000,132511035,78511035,Vista,132
1949,Zodiac,Zodiac,7.5,2007,65000000,84785914,19785914,Vista,158
4922,El curioso caso de Benjamin Button,The Curious Case of Benjamin Button,7.6,2008,150000000,333932083,183932083,Vista,159
564,La momia,The Mummy,6.8,1999,80000000,415885488,335885488,Vista,125
1734,El regreso de la momia,The Mummy Returns,6.3,2001,98000000,443280904,345280904,Vista,129
9334,El rey Escorpión,The Scorpion King,5.5,2002,60000000,165333180,105333180,Vista,92
282035,La momia,The Mummy,5.5,2017,125000000,409231607,284231607,Vista,110
13223,Gran Torino,Gran Torino,8.0,2008,33000000,269958228,236958228,Vista,112
98,Gladiator,Gladiator,8.2,2000,103000000,465361176,362361176,Vista,155
773,Pequeña Miss Sunshine,Little Miss Sunshine,7.6,2006,8000000,100523181,92523181,Vista,101
24,Kill Bill: Volumen 1,Kill Bill: Vol. 1,8.0,2003,30000000,180899265,150899265,Pendiente,111
393,Kill Bill: Volumen 2,Kill Bill: Vol. 2,7.9,2004,30000000,152159461,122159461,Pendiente,136
16869,Malditos bastardos,Inglourious Basterds,8.2,2009,70000000,321455689,251455689,Vista,146
343674,El juego de Gerald,Gerald's Game,6.4,2017,0,0,0,Vista,103
523139,En la hierba alta,In the Tall Grass,5.5,2019,0,0,0,Vista,102
433808,El ritual,The Ritual,6.1,2017,10000000,1785977,-8214023,Vista,94
365995,Inside,Inside,5.0,2016,0,794979,794979,Vista,91
306947,La invitación,The Invitation,6.5,2015,0,354835,354835,Vista,100
397243,La autopsia de Jane Doe,The Autopsy of Jane Doe,6.6,2016,1500000,5972942,4472942,Vista,99
581600,Spenser: confidencial,Spenser Confidential,6.6,2020,0,0,0,Vista,110
605116,Proyecto Power,Project Power,6.6,2020,0,0,0,Vista,113
570670,El hombre invisible,The Invisible Man,7.2,2020,7000000,130234661,123234661,Pendiente,110
517116,La casa del terror (Haunt),Haunt,6.8,2019,0,1782200,1782200,Vista,92
440021,Feliz día de tu muerte,Happy Death Day,6.6,2017,4800000,122637878,117837878,Vista,96
512196,Feliz día de tu muerte 2,Happy Death Day 2U,6.3,2019,9000000,25327500,16327500,Vista,100
587792,Palm Springs,Palm Springs,7.4,2020,0,164000,164000,Pendiente,90
321258,The Boy,The Boy,5.9,2016,10000000,64188367,54188367,Vista,97
555974,The Boy: La maldición de Brahms,Brahms: The Boy II,6.2,2020,10000000,20311536,10311536,Pendiente,86
109424,Capitán Phillips,Captain Phillips,7.6,2013,55000000,95000000,40000000,Vista,134
157433,Cementerio de animales,Pet Sematary,5.8,2019,21000000,112399944,91399944,Vista,105
198184,Chappie,Chappie,6.8,2015,49000000,104399548,55399548,Vista,120
310,Como Dios,Bruce Almighty,6.7,2003,80000000,484592874,404592874,Vista,101
2698,Sigo como Dios,Evan Almighty,5.5,2007,175000000,173000000,-2000000,Vista,96
45612,Código fuente,Source Code,7.3,2011,32000000,147332697,115332697,Vista,87
10191,Cómo entrenar a tu dragón,How to Train Your Dragon,7.8,2010,165000000,494878759,329878759,Vista,98
82702,Cómo entrenar a tu dragón 2,How to Train Your Dragon 2,7.7,2014,145000000,609123048,464123048,Vista,105
38050,Destino oculto,The Adjustment Bureau,6.7,2011,50200000,127869379,77669379,Vista,106
205584,Dioses de Egipto,Gods of Egypt,5.6,2016,140000000,150680864,10680864,Vista,127
134374,Dolor y dinero,Pain & Gain,6.2,2013,25000000,87305549,62305549,Vista,130
388399,Día de patriotas,Patriots Day,7.0,2016,45000000,50548152,5548152,Vista,130
119450,El amanecer del planeta de los simios,Dawn of the Planet of the Apes,7.3,2014,170000000,710644566,540644566,Vista,130
61791,El origen del planeta de los simios,Rise of the Planet of the Apes,7.3,2011,93000000,482860185,389860185,Vista,110
281338,La guerra del planeta de los simios,War for the Planet of the Apes,7.1,2017,150000000,488533726,338533726,Vista,140
329440,El bosque de los suicidios,The Forest,5.1,2016,10000000,37608299,27608299,Vista,94
70436,El enigma del cuervo,The Raven,6.3,2012,26000000,29657751,3657751,Vista,111
49521,El hombre de acero,Man of Steel,6.6,2013,225000000,754045518,529045518,Vista,148
50348,El inocente,The Lincoln Lawyer,7.2,2011,40000000,85412898,45412898,Vista,120
82693,El lado bueno de las cosas,Silver Linings Playbook,7.1,2012,21000000,236412453,215412453,Vista,122
714,El mañana nunca muere,Tomorrow Never Dies,6.3,1997,110000000,333011068,223011068,Vista,119
36643,El mundo nunca es suficiente,The World Is Not Enough,6.2,1999,135000000,361832400,226832400,Vista,128
3594,El número 23,The Number 23,6.5,2007,30000000,77566815,47566815,Vista,100
399035,El pasajero,The Commuter,6.3,2018,30000000,119942387,89942387,Vista,105
447200,El rascacielos,Skyscraper,6.3,2018,125000000,292351275,167351275,Vista,103
616,El último samurái,The Last Samurai,7.5,2003,140000000,456758981,316758981,Vista,154
316727,Election: La noche de las bestias,The Purge: Election Year,6.4,2016,10000000,118587880,108587880,Vista,109
68724,Elysium,Elysium,6.5,2013,115000000,286140700,171140700,Vista,109
853,Enemigo a las puertas,Enemy at the Gates,7.4,2001,68000000,96976270,28976270,Vista,131
7214,Entrenador Carter,Coach Carter,7.5,2005,30000000,76669806,46669806,Vista,140
253412,Everest,Everest,6.8,2015,55000000,203427584,148427584,Vista,121
10466,Esta casa es una ruina,The Money Pit,6.4,1986,10000000,54999651,44999651,Vista,91
539537,Fantasy Island,Fantasy Island,6.1,2020,7000000,47078545,40078545,Vista,110
14869,G.I. Joe,G.I. Joe: The Rise of Cobra,5.7,2009,175000000,302469017,127469017,Vista,118
72559,G.I. Joe: La venganza,G.I. Joe: Retaliation,5.5,2013,130000000,371876278,241876278,Vista,110
274855,Geostorm,Geostorm,6.0,2017,120000000,221600160,101600160,Vista,109
22972,Green Zone: Distrito protegido,Green Zone,6.5,2010,100000000,154711438,54711438,Vista,115
8960,Hancock,Hancock,6.3,2008,150000000,629443428,479443428,Vista,92
324786,Hasta el último hombre,Hacksaw Ridge,8.1,2016,40000000,175302354,135302354,Vista,131
456740,Hellboy,Hellboy,5.5,2019,50000000,44664690,-5335310,Vista,125
11970,Hércules,Hercules,7.5,1997,85000000,252712101,167712101,Vista,93
44048,Imparable,Unstoppable,6.5,2010,100000000,167805466,67805466,Vista,98
332567,Infierno azul,The Shallows,6.3,2016,17000000,119100758,102100758,Vista,86
511987,Infierno bajo el agua,Crawl,6.3,2019,13500000,89203432,75703432,Vista,88
64688,Infiltrados en clase,21 Jump Street,6.9,2012,42000000,201585328,159585328,Vista,109
187017,Infiltrados en la universidad,22 Jump Street,6.9,2014,50000000,188441614,138441614,Vista,120
406563,Insidious: La última llave,Insidious: The Last Key,6.2,2018,10000000,167184112,157184112,Vista,103
109414,Juerga hasta el fin,This Is the End,6.2,2013,32000000,126041322,94041322,Vista,107
22970,La cabaña en el bosque,The Cabin in the Woods,6.6,2012,30000000,71041255,41041255,Vista,95
514847,La caza,The Hunt,6.7,2020,14000000,11370169,-2629831,Vista,90
18937,La espada mágica,Quest for Camelot,6.8,1998,40000000,38172500,-1827500,Vista,86
311324,La gran muralla,The Great Wall,5.9,2016,150000000,331957105,181957105,Vista,103
71469,La hora más oscura,The Darkest Hour,5.2,2011,30000000,64626786,34626786,Vista,89
300673,La hora decisiva,The Finest Hours,6.5,2016,80000000,52099090,-27900910,Vista,117
480414,La Llorona,The Curse of La Llorona,5.7,2019,9000000,122033739,113033739,Vista,93
37799,La red social,The Social Network,7.3,2010,40000000,224920315,184920315,Vista,120
22907,Ladrones,Takers,6.2,2010,32000000,69055695,37055695,Vista,107
395992,Life (Vida),Life,6.4,2017,58000000,100541806,42541806,Vista,104
76341,Mad Max: Furia en la carretera,Mad Max: Fury Road,7.5,2015,150000000,378858340,228858340,Vista,120
36955,Mentiras arriesgadas,True Lies,7.0,1994,115000000,378882411,263882411,Vista,141
1624,Mentiroso compulsivo,Liar Liar,6.6,1997,45000000,302710615,257710615,Vista,86
396371,Molly's Game,Molly's Game,7.1,2017,30000000,59284015,29284015,Vista,141
333371,Calle Cloverfield 10,10 Cloverfield Lane,7.0,2016,15000000,108286421,93286421,Vista,103
521935,Cam,Cam,5.9,2018,1000000,0,-1000000,Vista,94
754,Cara a cara,Face/Off,7.0,1997,80000000,245676146,165676146,Vista,138
425972,Cargo,Cargo,6.4,2017,0,56385,56385,Vista,105
8398,Carretera al infierno,The Hitcher,5.8,2007,10000000,25399945,15399945,Vista,90
345914,Casa casino,The House,5.7,2017,40000000,0,-40000000,Vista,88
7278,Casi 300,Meet the Spartans,3.9,2008,30000000,84646831,54646831,Vista,88
459992,Casi imposible,Long Shot,6.8,2019,40000000,53847136,13847136,Vista,120
314,Catwoman,Catwoman,4.5,2004,100000000,82102379,-17897621,Vista,104
77663,Caza humana,Killing Season,5.5,2013,0,39881,39881,Vista,90
43074,Cazafantasmas,Ghostbusters,5.4,2016,144000000,229147509,85147509,Vista,116
33273,Celda 211,Celda 211,7.5,2009,5700000,19300483,13600483,Vista,110
9759,Cellular,Cellular,6.3,2004,25000000,56422687,31422687,Vista,94
23759,Centurión,Centurion,6.2,2010,12000000,6890432,-5109568,Vista,97
118,Charlie y la fábrica de chocolate,Charlie and the Chocolate Factory,7.0,2005,150000000,474968763,324968763,Vista,116
76726,Chronicle,Chronicle,6.7,2012,15000000,145000000,130000000,Vista,83
351809,Cien años de perdón,Cien años de perdón,6.2,2016,6700000,9074836,2374836,Vista,98
9339,Click,Click,6.2,2006,82500000,240685326,158185326,Vista,107
112454,Clown,Clown,5.5,2014,0,2381961,2381961,Vista,100
1538,Collateral,Collateral,7.2,2004,65000000,217764291,152764291,Vista,120
37430,Conan el bárbaro,Conan the Barbarian,5.2,2011,90000000,63523283,-26476717,Vista,113
77866,Contraband,Contraband,6.3,2012,25000000,96262212,71262212,Vista,109
411088,Contratiempo,Contratiempo,8.2,2016,4000000,30000000,26000000,Vista,106
599975,Countdown: La hora de tu muerte,Countdown,6.4,2019,6500000,48021766,41521766,Vista,90
49849,Cowboys & Aliens,Cowboys & Aliens,5.5,2011,163000000,174822325,11822325,Vista,119
1948,Crank: Veneno en la sangre,Crank,6.6,2006,12000000,42931041,30931041,Vista,87
15092,Crank: Alto voltaje,Crank: High Voltage,6.0,2009,20000000,34560577,14560577,Vista,96
8966,Crepúsculo,Twilight,6.3,2008,37000000,393616788,356616788,Vista,122
9534,Crimen Ferpecto,Crimen Ferpecto,6.6,2004,6000000,9042432,3042432,Vista,105
514999,Criminales en el mar,Murder Mystery,6.3,2019,24000000,0,-24000000,Vista,97
166424,Cuatro fantásticos,Fantastic Four,4.4,2015,120000000,167977596,47977596,Vista,100
375872,Cuerpo de élite,Cuerpo de élite,5.0,2016,5157375,7145405,1988030,Vista,97
9472,Cuestión de pelotas,DodgeBall: A True Underdog Story,6.3,2004,20000000,167722310,147722310,Vista,92
461130,Código 8,Code 8,6.2,2019,0,157209,157209,Vista,99
51540,Cómo acabar con tu jefe,Horrible Bosses,6.6,2011,35000000,209838559,174838559,Vista,98
227159,Cómo acabar sin tu jefe 2,Horrible Bosses 2,6.2,2014,42000000,107670357,65670357,Vista,108
9480,Daredevil,Daredevil,5.2,2003,78000000,179179718,101179718,Vista,103
10073,Date Movie,Date Movie,4.1,2006,20000000,48548426,28548426,Vista,84
9522,De boda en boda,Wedding Crashers,6.5,2005,40000000,285176741,245176741,Vista,119
1991,Death Proof,Death Proof,6.8,2007,25000000,30207393,5207393,Vista,114
106,Depredador,Predator,7.4,1987,15000000,98267558,83267558,Vista,102
64635,Desafío total,Total Recall,5.9,2012,125000000,198802074,73802074,Vista,121
87428,Desmadre de padre,That's My Boy,5.7,2012,70000000,58058367,-11941633,Vista,114
433251,Desnudo,Naked,5.8,2017,0,0,0,Vista,96
13483,Despierto,Awake,6.3,2007,86000000,32730062,24130062,Vista,84
9532,Destino final,Final Destination,6.5,2000,23000000,112880294,89880294,Vista,98
9358,Destino final 2,Final Destination 2,6.2,2003,26000000,90941129,64941129,Vista,90
9286,Destino final 3,Final Destination 3,6.0,2006,25000000,118890272,93890272,Vista,92
19912,Destino final 4,The Final Destination,5.6,2009,40000000,186167139,146167139,Vista,82
55779,Destino final 5,Final Destination 5,6.0,2011,47000000,157887643,110887643,Vista,95
7552,Dick y Jane: ladrones de risa,Fun with Dick and Jane,6.1,2005,100000000,202026112,102026112,Vista,90
13805,Disaster Movie,Disaster Movie,3.2,2008,25000000,14109284,-10890716,Vista,87
8271,Disturbia,Disturbia,6.7,2007,20000000,117760134,97760134,Vista,105
68718,Django desencadenado,Django Unchained,8.1,2012,100000000,425368238,325368238,Vista,165
11007,Doce en casa,Cheaper by the Dozen,6.3,2003,40000000,190212113,150212113,Vista,98
9641,Doce fuera de casa,Cheaper by the Dozen 2,6.1,2005,60000000,129181830,69181830,Vista,93
290250,Dos buenos tipos,The Nice Guys,7.1,2016,50000000,62788218,12788218,Vista,116
419680,Dos padres por desigual,Daddy's Home 2,6.2,2017,69000000,180613180,111613180,Vista,100
12153,Dos rubias de pelo en pecho,White Chicks,6.9,2004,37000000,113086475,76086475,Vista,109
503314,Dragon Ball Super: Broly,ドラゴンボール超スーパー ブロリー,7.8,2018,1000000,125002821,124002821,Vista,100
49017,Drácula: la leyenda jamás contada,Dracula Untold,6.3,2014,70000000,217124280,147124280,Vista,92
7551,Déjà Vu,Déjà Vu,6.8,2006,75000000,180557550,105557550,Vista,126
206033,Días de cine,Días de cine,5.0,2007,0,636029,636029,Vista,96
54148,Días de fútbol,Días de fútbol,6.3,2003,0,12212123,12212123,Vista,118
420648,El bar,El bar,6.3,2017,6045750,3662671,-2383079,Vista,102
257211,El becario,The Intern,7.2,2015,35000000,194564672,159564672,Vista,121
49520,El cambiazo,The Change-Up,6.1,2011,52000000,75450437,23450437,Vista,112
57431,El canguro,The Sitter,5.5,2011,25000000,34942188,9942188,Vista,81
24418,El circo de los extraños,Cirque du Freak: The Vampire's Assistant,5.7,2009,40000000,28169671,-11830329,Vista,109
198663,El corredor del laberinto,The Maze Runner,7.1,2014,34000000,348319861,314319861,Vista,113
351145,El desconocido,El desconocido,6.8,2015,4670099,3532967,-1137132,Vista,95
76493,El dictador,The Dictator,6.1,2012,65000000,179379533,114379533,Vista,83
435,El día de mañana,The Day After Tomorrow,6.4,2004,125000000,544272402,419272402,Vista,124
1954,El efecto mariposa,The Butterfly Effect,7.5,2004,13000000,96060858,83060858,Vista,113
34544,El equipo A,The A-Team,6.3,2010,110000000,177238796,67238796,Vista,121
190859,El francotirador,American Sniper,7.4,2014,58800000,542307423,483507423,Vista,132
10386,El gigante de hierro,The Iron Giant,7.9,1999,70000000,23159305,-46840695,Vista,86
531309,El hijo,Brightburn,6.0,2019,6000000,32893421,26893421,Vista,91
251519,El hijo de Batman,Son of Batman,7.0,2014,0,0,0,Vista,74
9313,El hombre de la máscara de hierro,The Man in the Iron Mask,6.6,1998,35000000,182968902,147968902,Vista,132
8645,El incidente,The Happening,5.3,2008,60000000,163403799,103403799,Vista,90
1724,El increíble Hulk,The Incredible Hulk,6.2,2008,150000000,163712074,13712074,Vista,114
10545,El jorobado de Notre Dame,The Hunchback of Notre Dame,7.1,1996,100000000,100138851,138851,Vista,91
205587,El juez,The Judge,7.3,2014,50000000,83719388,33719388,Vista,141
284536,El jugador,The Gambler,5.8,2014,25000000,39171130,14171130,Vista,110
106646,El lobo de Wall Street,The Wolf of Wall Street,8.0,2013,100000000,392000000,292000000,Vista,180
134411,El mensajero,Snitch,6.0,2013,35000000,42930462,7930462,Vista,112
405775,The Wall,The Wall,6.2,2017,0,1803009,1803009,Vista,90
14574,El niño con el pijama de rayas,The Boy in the Striped Pyjamas,7.9,2008,12500000,20416563,7916563,Vista,94
9281,Único testigo,Witness,7.1,1985,12000000,68706993,56706993,Pendiente,112
44564,¡Qué dilema!,The Dilemma,5.3,2011,70000000,67112664,-2887336,Pendiente,111
7553,¡Marchando!,Waiting...,6.3,2005,3000000,18637690,15637690,Pendiente,94
14451,Zombis nazis,Død snø,6.0,2009,800000,2166797,1366797,Pendiente,92
241842,Zombis nazis 2,Død Snø 2,6.6,2014,0,37473,37473,Pendiente,100
314095,Z: la ciudad perdida,The Lost City of Z,6.3,2016,30000000,8574339,-21425661,Pendiente,141
11679,xXx2: Estado de emergencia,xXx: State of the Union,5.0,2005,60000000,71073932,11073932,Pendiente,101
7451,xXx,xXx,5.9,2002,70000000,277448382,207448382,Pendiente,124
630586,Wrong Turn,Wrong Turn,7.3,2021,0,0,0,Pendiente,110
537055,Wonder Woman: Linaje,Wonder Woman: Bloodlines,7.2,2019,0,0,0,Pendiente,83
395834,Wind River,Wind River,7.4,2017,11000000,44998252,33998252,Pendiente,107
471014,Wheelman,Wheelman,6.0,2017,0,0,0,Pendiente,82
716703,What Lies Below,What Lies Below,6.3,2020,0,0,0,Pendiente,87
13183,Watchmen,Watchmen,7.3,2009,130000000,185258983,55258983,Pendiente,155
59440,Warrior,Warrior,7.8,2011,25000000,23057115,-1942885,Pendiente,140
33909,Wall Street: el dinero nunca duerme,Wall Street: Money Never Sleeps,6.1,2010,70000000,134748021,64748021,Pendiente,131
726208,Voces,Voces,6.5,2020,0,443458,443458,Pendiente,98
259695,Vivir de noche,Live by Night,6.2,2016,108000000,22678555,-85321445,Pendiente,128
458305,Vivarium,Vivarium,6.0,2019,4000000,427399,-3572601,Pendiente,100
401469,Viudas,Widows,6.5,2018,42000000,73866088,31866088,Pendiente,130
497698,Viuda negra,Black Widow,0.0,2021,200000000,0,-200000000,Pendiente,133
10285,Viernes 13: Jason se va al Infierno,Jason Goes to Hell: The Final Friday,4.4,1993,3000000,15938065,12938065,Pendiente,87
9730,Viernes 13. Último capítulo,Friday the 13th: The Final Chapter,6.0,1984,2600000,32980880,30380880,Pendiente,91
10283,Viernes 13. Parte VIII: Jason vuelve... para siempre,Friday the 13th Part VIII: Jason Takes Manhattan,4.9,1989,5000000,14000000,9000000,Pendiente,100
9731,Viernes 13. Parte V: Un nuevo comienzo,Friday the 13th: A New Beginning,5.3,1985,2200000,21930418,19730418,Pendiente,92
10281,Viernes 13. 7ª parte: Sangre nueva,Friday the 13th Part VII: The New Blood,5.4,1988,2800000,19170001,16370001,Pendiente,88
10225,Viernes 13. 6ª parte: Jason vive,Friday the 13th Part VI: Jason Lives,6.1,1986,3000000,19472057,16472057,Pendiente,86
9728,Viernes 13. parte III,Friday the 13th Part III,5.8,1982,4000000,36690067,32690067,Pendiente,95
9725,Viernes 13. 2ª parte,Friday the 13th Part 2,6.1,1981,1250000,21722776,20472776,Pendiente,87
4488,Viernes 13,Friday the 13th,6.4,1980,550000,59754601,59204601,Pendiente,95
587986,Ventajas de viajar en tren,Ventajas de viajar en tren,6.3,2019,0,405517,405517,Pendiente,104
580489,Venom: Habrá Matanza,Venom: Let There Be Carnage,0.0,2021,0,0,0,Pendiente,0
438650,Venganza bajo cero,Cold Pursuit,5.6,2019,60000000,76419755,16419755,Pendiente,118
193893,Vamos de polis,Let's Be Cops,6.4,2014,17000000,136621271,119621271,Pendiente,104
44264,Valor de ley,True Grit,7.3,2010,38000000,252276927,214276927,Pendiente,108
500664,Upgrade (Ilimitado),Upgrade,7.5,2018,5000000,16593554,11593554,Pendiente,100
335787,Uncharted: Drake's Fortune,Uncharted,0.0,2022,0,0,0,Pendiente,0
130150,Una vida en tres días,Labor Day,6.9,2013,18000000,20275812,2275812,Pendiente,111
301337,Una vida a lo grande,Downsizing,5.2,2017,68000000,55003890,-12996110,Pendiente,140
9535,Una terapia peligrosa,Analyze This,6.5,1999,80000000,176885658,96885658,Pendiente,103
241554,Una noche para sobrevivir,Run All Night,6.4,2015,50000000,71561644,21561644,Pendiente,114
567971,Vampiros contra el Bronx,Vampires vs. the Bronx,6.1,2020,0,0,0,Vista,86
1607,A Bronx Tale,A Bronx Tale,7.7,1993,10000000,17287898,7287898,Pendiente,121
301355,Message from the King,Message from the King,6.3,2016,10000000,0,-10000000,Vista,102
390051,Una historia de venganza,Aftermath,5.7,2017,10500000,261465,-10238535,Pendiente,92
43923,Una historia casi divertida,It's Kind of a Funny Story,7.0,2010,8000000,6491240,-1508760,Pendiente,101
70074,Una bala en la cabeza,Bullet to the Head,5.5,2013,55000000,9489829,-45510171,Pendiente,91
205588,Un traidor como los nuestros,Our Kind of Traitor,6.0,2016,0,9930095,9930095,Pendiente,108
595148,Un plan irresistible,Irresistible,6.0,2020,0,177418,177418,Pendiente,103
13195,Un plan brillante,Flawless,6.6,2007,20000000,6819587,-13180413,Pendiente,108
520763,Un lugar tranquilo 2,A Quiet Place Part II,0.0,2021,0,0,0,Pendiente,105
353070,Un golpe con estilo,Going in Style,6.7,2017,25000000,84618541,59618541,Pendiente,97
321751,Un día perfecto,A Perfect Day,6.6,2015,10000000,4011304,-5988696,Pendiente,106
9563,Un domingo cualquiera,Any Given Sunday,6.9,1999,55000000,100230832,45230832,Pendiente,162
1965,Un crimen perfecto,A Perfect Murder,6.5,1998,60000000,128038368,68038368,Pendiente,107
501907,Un amigo extraordinario,A Beautiful Day in the Neighborhood,7.1,2019,4000000,67760877,63760877,Pendiente,115
11808,U.S. Marshals,U.S. Marshals,6.4,1998,60000000,102367405,42367405,Pendiente,131
9796,Turistas,Turistas,5.4,2006,10000000,14321070,4321070,Pendiente,93
294016,Trumbo: La lista negra de Hollywood,Trumbo,7.2,2015,15000000,8235661,-6764339,Pendiente,124
146198,Triple 9,Triple 9,5.9,2016,20000000,12639297,-7360703,Pendiente,115
26466,Triangle,Triangle,6.9,2009,12000000,1594955,-10405045,Pendiente,99
8007,Tras la línea enemiga,Behind Enemy Lines,6.3,2001,40000000,91753202,51753202,Pendiente,106
4108,Transporter,The Transporter,6.7,2002,21000000,43928932,22928932,Pendiente,94
9335,Transporter 2,Transporter 2,6.3,2005,32000000,89083229,57083229,Pendiente,87
13387,Transporter 3,Transporter 3,6.1,2008,30000000,108979549,78979549,Pendiente,100
287948,Transporter Legacy,The Transporter Refueled,5.5,2015,25000000,72629670,47629670,Pendiente,96
157353,Transcendence,Transcendence,6.0,2014,100000000,103039258,3039258,Pendiente,119
2034,Training Day (Día de entrenamiento),Training Day,7.4,2001,45000000,104876233,59876233,Pendiente,121
1900,Traffic,Traffic,7.1,2000,48000000,207515725,159515725,Pendiente,140
1578,Toro salvaje,Raging Bull,8.0,1980,18000000,23000000,5000000,Pendiente,129
361743,Top Gun: Maverick,Top Gun: Maverick,0.0,2021,0,0,0,Pendiente,0
468224,Tolkien,Tolkien,7.0,2019,20000000,8654322,-11345678,Pendiente,112
446791,Todo el dinero del mundo,All the Money in the World,6.4,2017,50000000,56996304,6996304,Pendiente,132
616037,Thor 4: Love and Thunder,Thor: Love and Thunder,0.0,2022,0,0,0,Pendiente,0
476669,The King's Man: La primera misión,The King's Man,0.0,2021,0,0,0,Pendiente,0
45317,The Fighter,The Fighter,7.4,2010,25000000,93617009,68617009,Pendiente,113
277216,Straight Outta Compton,Straight Outta Compton,7.8,2015,28000000,201634991,173634991,Pendiente,147
28178,Siempre a tu lado (Hachiko),Hachi: A Dog's Tale,8.0,2009,16000000,46749646,30749646,Pendiente,93
400535,Sicario: el día del soldado,Sicario: Day of the Soldado,6.8,2018,35000000,75836683,40836683,Pendiente,122
9257,S.W.A.T.: Los hombres de Harrelson,S.W.A.T.,6.1,2003,80000000,116643346,36643346,Pendiente,117
13809,RocknRolla,RockNRolla,6.9,2008,18000000,25739015,7739015,Pendiente,114
9800,Philadelphia,Philadelphia,7.8,1993,26000000,206678440,180678440,Pendiente,125
567609,Noche de bodas,Ready or Not,7.0,2019,6000000,57615777,51615777,Pendiente,95
77495,Mientras duermes,Mientras duermes,7.0,2011,5000000,9109597,4109597,Pendiente,102
75,Mars Attacks!,Mars Attacks!,6.3,1996,70000000,101371017,31371017,Pendiente,106
9567,Lágrimas del sol,Tears of the Sun,6.7,2003,75000000,86468162,11468162,Pendiente,121
276907,Legend,Legend,6.9,2015,25000000,42972994,17972994,Pendiente,132
97630,La noche más oscura,Zero Dark Thirty,6.9,2012,40000000,132820716,92820716,Pendiente,157
329865,La llegada,Arrival,7.5,2016,47000000,203388186,156388186,Pendiente,116
154400,La entrega,The Drop,6.7,2014,12600000,19054534,6454534,Pendiente,106
1669,La caza del Octubre Rojo,The Hunt for Red October,7.4,1990,30000000,200512643,170512643,Pendiente,132
20766,La carretera (The Road),The Road,7.0,2009,32000000,27635305,-4364695,Pendiente,112
343668,Kingsman: El círculo de oro,Kingsman: The Golden Circle,7.0,2017,104000000,410902662,306902662,Pendiente,135
515001,Jojo Rabbit,Jojo Rabbit,8.1,2019,14000000,82468705,68468705,Pendiente,108
1690,Hostel,Hostel,5.9,2006,4800000,81979826,77179826,Pendiente,94
348350,Han Solo: Una historia de Star Wars,Solo: A Star Wars Story,6.6,2018,250000000,392952373,142952373,Pendiente,135
550988,Free Guy,Free Guy,0.0,2021,0,0,0,Pendiente,0
277685,Eliminado,Unfriended,5.5,2015,1000000,62882090,61882090,Vista,82
505058,Eliminado: Dark Web,Unfriended: Dark Web,6.3,2018,1000000,9602624,8602624,Vista,88
205775,En el corazón del mar,In the Heart of the Sea,6.7,2015,100000000,93920758,-6079242,Vista,121
8321,Escondidos en Brujas,In Bruges,7.5,2008,15000000,34533783,19533783,Vista,107
10294,Habitación sin salida,Vacancy,6.2,2007,19000000,35300645,16300645,Vista,85
8874,La boda de mi mejor amigo,My Best Friend's Wedding,6.6,1997,38000000,299288605,261288605,Vista,105
2059,La búsqueda (National Treasure),National Treasure,6.6,2004,100000000,347512318,247512318,Vista,130
6637,La búsqueda 2: El diario secreto,National Treasure: Book of Secrets,6.3,2007,130000000,459242249,329242249,Vista,124
594,La terminal,The Terminal,7.3,2004,60000000,219417255,159417255,Vista,129
179538,Las brujas de Zugarramurdi,Las brujas de Zugarramurdi,6.3,2013,8000000,6650778,-1349222,Vista,109
1979,Los 4 fantásticos y Silver Surfer,Fantastic Four: Rise of the Silver Surfer,5.6,2007,130000000,301913131,171913131,Vista,92
9738,Los 4 fantásticos,Fantastic Four,5.8,2005,100000000,333535934,233535934,Vista,105
27578,Los mercenarios,The Expendables,6.2,2010,80000000,274470394,194470394,Vista,103
76163,Los mercenarios 2,The Expendables 2,6.2,2012,100000000,314975955,214975955,Vista,102
138103,Los mercenarios 3,The Expendables 3,6.2,2014,90000000,206172544,116172544,Vista,123
27581,Los otros dos,The Other Guys,6.3,2010,100000000,170432927,70432927,Vista,107
35,Los Simpson: La película,The Simpsons Movie,7.0,2007,75000000,527068851,452068851,Vista,87
11631,Mamma Mia! La película,Mamma Mia!,6.9,2008,52000000,609841637,557841637,Vista,110
428078,Mortal Engines,Mortal Engines,6.1,2018,100000000,83672673,-16327327,Vista,128
533642,Muñeco diabólico,Child's Play,6.1,2019,10000000,44902237,34902237,Vista,90
445571,Noche de juegos,Game Night,6.8,2018,37000000,117501013,80501013,Vista,100
345911,Nunca apagues la luz,Lights Out,6.3,2016,4900000,148868835,143968835,Vista,90
292280,Nunca digas su nombre,The Bye Bye Man,5.2,2017,7400000,26667197,19267197,Vista,97
8358,Náufrago,Cast Away,7.6,2000,90000000,429632142,339632142,Vista,143
161,Ocean's Eleven. Hagan juego,Ocean's Eleven,7.4,2001,85000000,450717150,365717150,Vista,116
163,Ocean's Twelve,Ocean's Twelve,6.5,2004,110000000,362744280,252744280,Vista,120
298,Ocean's Thirteen,Ocean's Thirteen,6.7,2007,85000000,311312624,226312624,Vista,115
438396,Orígenes secretos,Orígenes secretos,6.2,2020,3268650,0,-3268650,Vista,97
12610,Osmosis Jones,Osmosis Jones,6.4,2001,75000000,13596911,-61403089,Vista,95
39513,Paul,Paul,6.6,2011,40000000,97552050,57552050,Vista,104
676,Pearl Harbor,Pearl Harbor,6.9,2001,140000000,449220945,309220945,Vista,184
23437,Pesadilla en Elm Street (El origen),A Nightmare on Elm Street,5.5,2010,35000000,115664037,80664037,Vista,102
346910,Predator,The Predator,5.6,2018,88000000,160542134,72542134,Vista,101
70981,Prometheus,Prometheus,6.5,2012,130000000,403170142,273170142,Vista,124
427641,Proyecto Rampage,Rampage,6.4,2018,120000000,426245950,306245950,Vista,107
376570,Pánico (Hush),Hush,6.8,2016,1000000,0,1000000,Vista,81
465003,Rescate en el mar Rojo,The Red Sea Diving Resort,6.9,2019,0,0,0,Vista,130
20662,Robin Hood,Robin Hood,6.4,2010,200000000,321669741,121669741,Vista,130
489999,Searching,Searching,7.6,2018,1000000,66265218,65265218,Vista,101
10528,Sherlock Holmes,Sherlock Holmes,7.2,2009,90000000,524028679,434028679,Vista,129
107,Snatch: Cerdos y diamantes,Snatch,7.8,2000,10000000,83557872,73557872,Vista,104
111083,El cuerpo,El cuerpo,7.6,2012,0,8779609,8779609,Vista,107
76757,El destino de Júpiter,Jupiter Ascending,5.4,2015,176000003,183987723,7987720,Vista,125
503619,El paquete,The Package,6.0,2018,0,0,0,Vista,94
378087,El pregón,El pregón,5.1,2016,0,2190829,2190829,Vista,85
9543,El príncipe de Persia: Las arenas del tiempo,Prince of Persia: The Sands of Time,6.2,2010,150000000,335154643,185154643,Vista,116
454227,El rey proscrito,Outlaw King,6.8,2018,120000000,0,-120000000,Vista,121
13022,El territorio de la bestia (Rogue),Rogue,6.4,2007,20000000,4609644,-15390356,Vista,99
10185,El vagón de la muerte,The Midnight Meat Train,6.1,2008,15000000,3533227,-11466773,Vista,100
11866,El vuelo del Fénix,Flight of the Phoenix,5.9,2004,45000000,21009180,-23990820,Vista,112
9947,Elektra,Elektra,5.0,2005,43000000,56681566,13681566,Vista,97
329010,Emelie,Emelie,5.2,2016,0,0,0,Vista,80
188222,Entourage. El séquito,Entourage,6.2,2015,30000000,49263404,19263404,Vista,104
435050,Es por tu bien,Es por tu bien,6.0,2017,2700000,11202953,8502953,Vista,93
2486,Eragon,Eragon,5.0,2006,100000000,249288105,149288105,Vista,104
297761,Suicide Squad,Suicide Squad,5.9,2016,175000000,746846894,571846894,Vista,123
454293,Escuela para fracasados,Night School,6.2,2018,29000000,33157615,4157615,Vista,112
1584,Escuela de Rock,School of Rock,7.0,2003,35000000,131282949,96282949,Vista,110
9352,Eurotrip,EuroTrip,6.5,2004,25000000,20796847,-4203153,Vista,93
43947,Escupiré sobre tu tumba,I Spit on Your Grave,6.5,2010,2000000,572809,-1427191,Vista,108
29917,Examen,Exam,6.7,2009,600000,0,-600000,Vista,101
138843,Expediente Warren: The Conjuring,The Conjuring,7.5,2013,13000000,319494638,306494638,Vista,112
259693,Expediente Warren: el caso Enfield,The Conjuring 2,7.2,2016,40000000,320392818,280392818,Vista,134
51497,Fast & Furious 5,Fast Five,7.2,2011,125000000,626137675,501137675,Vista,130
82992,Fast & Furious 6,Fast & Furious 6,6.8,2013,160000000,788679850,628679850,Vista,130
384682,Fiesta de empresa,Office Christmas Party,5.6,2016,45000000,114501299,69501299,Vista,105
531454,Festival de la Canción de Eurovisión: La historia de Fire Saga,Eurovision Song Contest: The Story of Fire Saga,6.5,2020,0,0,0,Vista,123
6466,Freddy contra Jason,Freddy vs. Jason,5.9,2003,30000000,114908830,84908830,Vista,97
15953,Fuera de carta,Fuera de carta,5.8,2008,4851000,6199712,1348712,Vista,111
18120,Fuga de cerebros,Fuga de Cerebros,5.3,2009,0,8323365,8323365,Vista,105
80105,Fuga de cerebros 2,Fuga de cerebros 2,5.1,2011,4002075,7080080,3078005,Vista,106
10603,George de la jungla,George of the Jungle,5.6,1997,55000000,174463257,119463257,Vista,92
11281,Halloween 2: Sanguinario,Halloween II,6.5,1981,2500000,25533818,23033818,Vista,90
11357,Halloween 4: El regreso de Michael Myers,Halloween 4: The Return of Michael Myers,6.0,1988,5000000,17768757,12768757,Vista,88
11361,Halloween 5 - La venganza de Michael Myers,Halloween 5: The Revenge of Michael Myers,5.4,1989,5000000,11642254,6642254,Vista,97
1248,Hannibal: el origen del mal,Hannibal Rising,6.2,2007,50000000,82169884,32169884,Vista,117
1487,Hellboy,Hellboy,6.6,2004,66000000,99318987,33318987,Vista,119
11253,Hellboy II: El ejército dorado,Hellboy II: The Golden Army,6.7,2008,85000000,160388063,75388063,Vista,114
12133,Hermanos por pelotas,Step Brothers,6.5,2008,65000000,128107642,63107642,Vista,98
417384,Historias de miedo para contar en la oscuridad,Scary Stories to Tell in the Dark,6.4,2019,25000000,95438172,70438172,Vista,108
10947,High School Musical,High School Musical,6.6,2006,4200000,0,-4200000,Vista,98
13649,High School Musical 2,High School Musical 2,6.5,2007,0,7000000,7000000,Vista,111
11887,High School Musical 3: Fin de curso,High School Musical 3: Senior Year,6.6,2008,11000000,252909177,241909177,Vista,112
8923,Hooligans,Green Street Hooligans,7.2,2005,0,4154346,4154346,Vista,109
301846,Howl (Aullido),Howl,5.3,2015,0,480783,480783,Vista,95
40264,Híncame el diente,Vampires Suck,4.2,2010,20000000,80547866,60547866,Vista,82
37958,Immortals,Immortals,5.9,2011,75000000,226904017,151904017,Vista,110
49530,In Time,In Time,6.9,2011,40000000,173930596,133930596,Vista,109
299245,La horca,The Gallows,4.9,2015,100000,42664410,42564410,Vista,87
1656,La leyenda del Zorro,The Legend of Zorro,6.1,2005,75000000,142400065,67400065,Vista,125
487670,La muerte de Superman,The Death of Superman,7.5,2018,0,0,0,Vista,81
433310,La primera vez que nos vimos,When We First Met,6.6,2018,10000000,0,-10000000,Vista,97
10591,La vecina de al lado,The Girl Next Door,6.7,2004,21000000,31635150,10635150,Vista,108
1586,La ventana secreta,Secret Window,6.6,2004,40000000,92913171,52913171,Vista,140
547016,La vieja guardia,The Old Guard,7.3,2020,70000000,0,-70000000,Vista,126
1995,Lara Croft: Tomb Raider,Lara Croft: Tomb Raider,5.9,2001,115000000,274703340,159703340,Vista,105
1996,Lara Croft: Tomb Raider 2 - La cuna de la vida,Lara Croft: Tomb Raider - The Cradle of Life,5.7,2003,95000000,160099222,65099222,Vista,118
411,"Las crónicas de Narnia: El león, la bruja y el armario","The Chronicles of Narnia: The Lion, the Witch and the Wardrobe",7.1,2005,180000000,745013115,565013115,Vista,143
2454,Las crónicas de Narnia: El príncipe Caspian,The Chronicles of Narnia: Prince Caspian,6.6,2008,225000000,419665568,194665568,Vista,144
11544,Lilo & Stitch,Lilo & Stitch,7.5,2002,80000000,145771527,65771527,Vista,90
377587,Los Blacks se van de purga,Meet the Blacks,4.7,2016,900000,9097072,8197072,Vista,90
34813,Los perdedores,The Losers,6.2,2010,25000000,23580000,-1420000,Vista,98
43539,Los próximos tres días,The Next Three Days,7.0,2010,30000000,51148651,21148651,Vista,133
6038,Los rebeldes de Shanghai,Shanghai Knights,6.1,2003,50000000,88323487,38323487,Vista,115
458897,Los ángeles de Charlie,Charlie's Angels,6.7,2019,48000000,73279888,25279888,Vista,125
4327,Los ángeles de Charlie,Charlie's Angels,5.8,2000,92000000,264105545,172105545,Vista,98
9471,Los ángeles de Charlie: Al límite,Charlie's Angels: Full Throttle,5.5,2003,120000000,259175788,139175788,Vista,105
381283,Madre!,mother!,7.0,2017,30000000,44516999,14516999,Vista,121
195589,Malditos vecinos,Neighbors,6.2,2014,18000000,270665134,252665134,Vista,96
325133,Malditos vecinos 2,Neighbors 2: Sorority Rising,5.8,2016,35000000,108758521,73758521,Vista,92
458594,Matar o morir (Peppermint),Peppermint,6.6,2018,25000000,48818723,23818723,Vista,101
9822,Mi gran amigo Joe,Mighty Joe Young,6.2,1998,90000000,50632037,-39367963,Vista,125
316023,Mike y Dave buscan rollo serio,Mike and Dave Need Wedding Dates,6.1,2016,33000000,77068246,44068246,Vista,98
46838,Tucker & Dale contra el mal,Tucker and Dale vs. Evil,7.3,2010,5000000,5224938,224938,Vista,89
188161,Mil maneras de morder el polvo,A Million Ways to Die in the West,5.9,2014,40000000,86410000,46410000,Vista,116
303858,Money Monster,Money Monster,6.5,2016,27000000,93282604,66282604,Vista,98
7191,Monstruoso,Cloverfield,6.6,2008,25000000,170764026,145764026,Vista,85
36419,Más allá de la muerte,After.Life,6.0,2009,4500000,3606395,-893605,Vista,104
328387,Nerve: Un juego sin reglas,Nerve,7.1,2016,19000000,85241496,66241496,Vista,96
34016,Ni en sueños,She's Out of My League,6.3,2010,20000000,49779728,29779728,Vista,104
11397,No es otra estúpida película americana,Not Another Teen Movie,5.7,2001,16000000,66468332,50468332,Vista,85
225574,Non-Stop (Sin escalas),Non-Stop,6.8,2014,50000000,222809600,172809600,Vista,106
2023,Océanos de fuego (Hidalgo),Hidalgo,6.7,2004,100000000,108103450,8103450,Vista,136
227348,Paranormal Activity: Los señalados,Paranormal Activity: The Marked Ones,5.4,2014,5000000,86362372,81362372,Vista,84
346671,Pequeño demonio,Little Evil,5.6,2017,0,0,0,Vista,95
542931,Perdiendo el este,Perdiendo el este,4.6,2019,0,3288447,3288447,Vista,89
264729,Perdiendo el norte,Perdiendo el norte,6.1,2015,0,11438207,11438207,Vista,102
435126,Perfectos desconocidos,Perfectos desconocidos,6.6,2017,0,31166312,31166312,Vista,96
257344,Pixels,Pixels,5.7,2015,88000000,243637091,155637091,Vista,105
9315,Plan de vuelo: desaparecida,Flightplan,6.4,2005,55000000,223387299,168387299,Vista,98
57214,Project X,Project X,6.7,2012,12000000,100000000,88000000,Vista,91
227719,Project Almanac,Project Almanac,6.6,2015,12000000,33213241,21213241,Vista,107
86541,Promoción fantasma,Promoción fantasma,6.3,2012,0,319573,319573,Vista,88
13455,Push,Push,6.1,2009,38000000,45465299,7465299,Vista,111
333339,Ready Player One,Ready Player One,7.6,2018,175000000,582890172,407890172,Vista,140
13515,Reflejos,Mirrors,6.2,2008,35000000,72436439,37436439,Vista,112
274857,Rey Arturo: la leyenda de Excalibur,King Arthur: Legend of the Sword,6.5,2017,175000000,148675066,-26324934,Vista,126
14564,Rings,Rings,5.0,2017,25000000,83080890,58080890,Vista,117
110415,Rompenieves,Snowpiercer,6.9,2013,39200000,86758912,47558912,Vista,126
22538,Scott Pilgrim contra el mundo,Scott Pilgrim vs. the World,7.4,2010,60000000,47664559,-12335441,Vista,112
6068,Seis días y siete noches,Six Days Seven Nights,6.0,1998,70000000,164000000,94000000,Vista,98
58574,Sherlock Holmes: Juego de sombras,Sherlock Holmes: A Game of Shadows,7.1,2011,125000000,334615000,209615000,Vista,129
273481,Sicario,Sicario,7.3,2015,30000000,84025816,54025816,Vista,121
14411,Simbad: La leyenda de los siete mares,Sinbad: Legend of the Seven Seas,6.9,2003,60000000,80767884,20767884,Vista,90
771,Solo en casa,Home Alone,7.3,1990,18000000,476684675,458684675,Vista,102
772,Solo en casa 2: Perdido en Nueva York,Home Alone 2: Lost in New York,6.6,1992,18000000,358994850,340994850,Vista,120
62213,Sombras tenebrosas,Dark Shadows,6.0,2012,150000000,245527149,95527149,Vista,113
138832,Somos los Miller,We're the Millers,6.8,2013,37000000,269994119,232994119,Vista,110
454626,Sonic: La película,Sonic the Hedgehog,7.5,2020,85000000,306766470,221766470,Vista,99
6479,Soy leyenda,I Am Legend,7.2,2007,150000000,585410052,435410052,Vista,100
314365,Spotlight,Spotlight,7.8,2015,20000000,98690254,78690254,Vista,128
787,Sr. y Sra. Smith,Mr. & Mrs. Smith,6.7,2005,110000000,478207520,368207520,Vista,120
10137,Stuart Little,Stuart Little,6.0,1999,133000000,300135367,167135367,Vista,84
11918,Superhero Movie,Superhero Movie,5.1,2008,35000000,25871834,-9128166,Vista,85
69798,Supercutres,The Inbetweeners Movie,6.2,2011,4478250,88823111,84344861,Vista,97
10189,Superfumados,Pineapple Express,6.6,2008,27000000,101624843,74624843,Vista,111
1452,Superman Returns: El regreso,Superman Returns,5.6,2006,270000000,391081192,121081192,Vista,154
3989,Team America: La policía del mundo,Team America: World Police,6.7,2004,32000000,50907422,18907422,Vista,98
623491,The Babysitter: Killer Queen,The Babysitter: Killer Queen,6.6,2020,0,0,0,Vista,101
419479,The Babysitter,The Babysitter,6.1,2017,0,0,0,Vista,85
87499,The East,The East,6.6,2013,6500000,2401510,-4098490,Vista,116
205596,The Imitation Game (Descifrando Enigma),The Imitation Game,8.0,2014,14000000,233555708,219555708,Vista,115
228967,The Interview,The Interview,6.2,2014,44000000,12342632,-31657368,Vista,112
263472,Toc Toc,Knock Knock,5.2,2015,2500000,6341684,3841684,Vista,99
437033,Toc Toc,Toc Toc,7.0,2017,3500000,7200000,3700000,Vista,96
399361,Triple frontera,Triple Frontier,6.3,2019,0,0,0,Vista,125
652,Troya,Troy,7.1,2004,175000000,497409852,322409852,Vista,163
7446,"Tropic Thunder, ¡una guerra muy perra!",Tropic Thunder,6.6,2008,92000000,195702811,103702811,Vista,107
83899,Tú eres el siguiente,You're Next,6.6,2011,1000000,26817459,25817459,Vista,96
341013,Atómica,Atomic Blonde,6.4,2017,30000000,100014025,70014025,Pendiente,115
266396,Caza al asesino,The Gunman,5.7,2015,40000000,13644292,-26355708,Pendiente,115
412656,Chaos Walking,Chaos Walking,0.0,2021,125000000,0,-125000000,Pendiente,109
44214,Cisne negro,Black Swan,7.6,2010,13000000,329398046,316398046,Pendiente,109
884,Crash,Crash,6.6,1996,10000000,2667076,-7332924,Pendiente,96
97367,Cruce de caminos,The Place Beyond the Pines,6.9,2013,15000000,35485608,20485608,Pendiente,135
861,Desafío total,Total Recall,7.2,1990,65000000,261317921,196317921,Pendiente,113
9573,Deuda de sangre,Blood Work,6.2,2002,50000000,31794718,-18205282,Pendiente,111
374720,Dunkerque,Dunkirk,7.5,2017,100000000,525573161,425573161,Pendiente,107
1598,El cabo del miedo,Cape Fear,7.3,1991,35000000,182300000,147300000,Pendiente,128
45269,El discurso del rey,The King's Speech,7.7,2010,15000000,414211549,399211549,Pendiente,118
3131,Gangs of New York,Gangs of New York,7.3,2002,100000000,193772504,93772504,Pendiente,170
4970,Gothika,Gothika,6.1,2003,40000000,141591324,101591324,Pendiente,95
318846,La gran apuesta,The Big Short,7.3,2015,28000000,133346506,105346506,Pendiente,130
10592,La guerra de Hart,Hart's War,6.3,2002,70000000,32287044,-37712956,Pendiente,125
526896,Morbius,Morbius,0.0,2022,0,0,0,Pendiente,0
615457,Nadie,Nobody,0.0,2021,0,0,0,Pendiente,92
9705,Operación Swordfish,Swordfish,6.2,2001,102000000,147080413,45080413,Pendiente,99
438799,Overlord,Overlord,6.7,2018,38000000,41657844,3657844,Pendiente,110
687,Pena de muerte,Dead Man Walking,7.4,1995,11000000,39363635,28363635,Pendiente,120
11551,Pequeños guerreros,Small Soldiers,6.5,1998,40000000,54682547,14682547,Vista,111
581997,Batman vs. las Tortugas Ninja,Batman vs. Teenage Mutant Ninja Turtles,7.2,2019,0,0,0,Vista,87
303991,Demolición,Demolition,6.7,2016,10000000,4366460,-5633540,Pendiente,101
289720,Desterrado,Outcast,4.9,2014,25000000,5148503,-19851497,Pendiente,98
141,Donnie Darko,Donnie Darko,7.8,2001,6000000,6979093,979093,Pendiente,113
319888,Eddie el Águila,Eddie the Eagle,7.2,2016,23000000,46152411,23152411,Pendiente,105
334517,El asedio de Jadotville,The Siege of Jadotville,7.2,2016,0,0,0,Pendiente,108
186,El caso Slevin,Lucky Number Slevin,7.5,2006,27000000,56308881,29308881,Pendiente,110
207,El club de los poetas muertos,Dead Poets Society,8.3,1989,16400000,235860116,219460116,Pendiente,128
9533,El dragón rojo,Red Dragon,7.0,2002,78000000,209196298,131196298,Pendiente,124
4553,El maquinista,The Machinist,7.5,2004,5000000,8203235,3203235,Pendiente,101
181283,El niño 44,Child 44,6.2,2015,50000000,3324330,-46675670,Pendiente,137
745,El sexto sentido,The Sixth Sense,7.9,1999,40000000,672806292,632806292,Pendiente,109
551804,Este cuerpo me sienta de muerte,Freaky,6.8,2020,5000000,15104310,10104310,Pendiente,101
524434,Eternals,Eternals,0.0,2021,0,0,0,Pendiente,0
17336,"Fighting, puños de asfalto",Fighting,5.9,2009,25000000,32474120,7484120,Pendiente,105
525,Granujas a todo ritmo (The Blues Brothers),The Blues Brothers,7.7,1980,27000000,115229890,88229890,Vista,133
11978,Hombres de honor,Men of Honor,7.4,2000,82343495,48814909,-33528586,Pendiente,150
418879,La guerra de las corrientes,The Current War,6.7,2019,0,0,0,Pendiente,105
399170,La suerte de los Logan,Logan Lucky,6.7,2017,29000000,48453605,19453605,Pendiente,119
12245,Los crímenes de Oxford,The Oxford Murders,5.9,2008,14000000,18000000,4000000,Pendiente,110
1770,Michael Collins,Michael Collins,6.9,1996,28000000,16900000,-11100000,Pendiente,132
10083,No hay salida,No Way Out,7.0,1987,15000000,35509515,20509515,Pendiente,116
9331,Peligro inminente,Clear and Present Danger,6.6,1994,62000000,215887717,153887717,Pendiente,141
8195,Ronin,Ronin,6.9,1998,55000000,70692101,15692101,Pendiente,122
370172,Sin tiempo para morir,No Time to Die,0.0,2021,242000000,0,-242000000,Pendiente,163
485774,Puertas abiertas,The Open House,3.7,2018,0,0,0,Vista,94
9760,Epic Movie,Epic Movie,3.8,2007,20000000,86865564,66865564,Vista,86
188207,Hércules: El origen de la leyenda,The Legend of Hercules,4.7,2014,70000000,61279452,-8720548,Vista,99
4247,Scary Movie,Scary Movie,6.3,2000,19000000,278019771,259019771,Vista,88
4248,Scary Movie 2,Scary Movie 2,5.7,2001,45000000,141220678,96220678,Vista,83
4256,Scary Movie 3,Scary Movie 3,6.0,2003,48000000,220673217,172673217,Vista,84
4257,Scary Movie 4,Scary Movie 4,5.5,2006,45000000,178262620,133262620,Vista,89
4258,Scary Movie 5,Scary Movie 5,4.8,2013,20000000,78378744,58378744,Vista,87
254474,Zombeavers (Castores zombies),Zombeavers,4.9,2014,0,14947,14947,Vista,85
42684,Skyline,Skyline,4.9,2010,10000000,66984887,56984887,Vista,96
271404,Beyond Skyline,Beyond Skyline,5.2,2017,20000000,992181,-19007819,Pendiente,105
9360,Anaconda,Anaconda,5.0,1997,45000000,136000000,91000000,Vista,90
347969,The Ridiculous 6,The Ridiculous 6,5.1,2015,60000000,0,-60000000,Vista,119
13184,Peligro en Bangkok,Bangkok Dangerous,5.2,2008,45000000,42487390,-2512610,Pendiente,99
316154,The Bad Batch,The Bad Batch,5.2,2016,6000000,180851,-5819149,Vista,119
122081,Spring Breakers,Spring Breakers,5.2,2012,5000000,31724284,26724284,Pendiente,94
401561,Mamá y papá,Mom and Dad,5.2,2017,4000000,169209,-3830791,Vista,83
77948,La fría luz del día,The Cold Light of Day,5.2,2012,20000000,16863583,-3136417,Vista,93
82700,After Earth,After Earth,5.2,2013,130000000,243843127,113843127,Pendiente,100
10048,Stealth: La amenaza invisible,Stealth,5.3,2005,135000000,76932943,-58067057,Vista,121
44113,Stone,Stone,5.3,2010,22000000,9479718,-12520282,Pendiente,105
6933,Llamada perdida,One Missed Call,5.5,2008,20000000,45847751,25847751,Vista,86
8665,K-19: The Widowmaker,K-19: The Widowmaker,6.4,2002,100000000,35168966,-64831034,Pendiente,138
9754,Firewall,Firewall,5.8,2006,45000000,82800000,37800000,Pendiente,105
2655,Lo que la verdad esconde,What Lies Beneath,6.4,2000,100000000,291420351,191420351,Pendiente,130
6950,Estallido,Outbreak,6.5,1995,50000000,189859560,139859560,Pendiente,127
10200,Ultimátum a la Tierra,The Day the Earth Stood Still,5.5,2008,80000000,233093859,153093859,Vista,110
440597,Siete deseos,Wish Upon,5.6,2017,12000000,14301505,2301505,Vista,98
456750,"Game Over, Man!","Game Over, Man!",5.6,2018,0,0,0,Vista,101
323368,El juego del ahorcado,Hangman,5.6,2017,0,0,0,Pendiente,120
869,El planeta de los simios,Planet of the Apes,5.7,2001,100000000,362211740,262211740,Vista,119
33,Sin perdón,Unforgiven,7.9,1992,14400000,159157447,144757447,Pendiente,131
183011,La Liga de la Justicia: La paradoja del tiempo,Justice League: The Flashpoint Paradox,7.9,2013,3500000,0,-3500000,Vista,75
322,Mystic River,Mystic River,7.7,2003,25000000,156822020,131822020,Pendiente,137
1700,Misery,Misery,7.7,1990,20000000,61276872,41276872,Pendiente,107
242582,Nightcrawler,Nightcrawler,7.7,2014,8500000,50300000,41800000,Pendiente,117
1592,Las dos caras de la verdad,Primal Fear,7.7,1996,30000000,102616183,72616183,Pendiente,129
1632,Arde Mississippi,Mississippi Burning,7.6,1988,15000000,34604000,19604000,Pendiente,128
820,JFK: caso abierto,JFK,7.6,1991,40000000,205405498,165405498,Pendiente,189
487558,Infiltrado en el KKKlan,BlacKkKlansman,7.6,2018,15000000,48686605,33686605,Pendiente,136
775996,A descubierto,Outside the Wire,6.5,2021,0,0,0,Pendiente,114
379291,La Liga de la Justicia contra los Jóvenes Titanes,Justice League vs. Teen Titans,7.2,2016,0,0,0,Vista,78
217993,La Liga de la Justicia: Guerra,Justice League: War,7.4,2014,3500000,5155325,1655325,Vista,79
94329,Redada asesina,Serbuan maut,7.4,2011,1100000,4105187,3005187,Pendiente,101
180299,Redada asesina 2,The Raid 2: Berandal,7.6,2014,4500000,6566916,2066916,Pendiente,148
9693,Hijos de los hombres,Children of Men,7.6,2006,76000000,70595464,-5404536,Pendiente,109
9495,El cuervo,The Crow,7.5,1994,15000000,94000000,79000000,Pendiente,102
408647,Jóvenes titanes: el contrato de Judas,Teen Titans: The Judas Contract,7.5,2017,0,0,0,Vista,84
516486,Greyhound: enemigos bajo el mar,Greyhound,7.4,2020,50300000,0,-50300000,Pendiente,92
76589,La Liga de la Justicia: Perdición,Justice League: Doom,7.4,2012,0,0,0,Vista,76
9509,El fuego de la venganza,Man on Fire,7.4,2004,70000000,130293714,60293714,Pendiente,170
5503,El fugitivo,The Fugitive,7.4,1993,44000000,368875760,324875760,Pendiente,133
453395,Doctor Strange 2: El Multiverso de la locura,Doctor Strange in the Multiverse of Madness,0.0,2022,0,0,0,Pendiente,0
566525,Shang-Chi y la Leyenda de los 10 Anillos,Shang-Chi and the Legend of the Ten Rings,0.0,2021,0,0,0,Pendiente,0
618355,Superman: Hijo Rojo,Superman: Red Son,7.4,2020,0,0,0,Vista,84
941,Lethal Weapon,Lethal Weapon,7.2,1987,15000000,120207127,105207127,Pendiente,110
942,Arma letal 2,Lethal Weapon 2,7.0,1989,25000000,227853986,202853986,Pendiente,114
943,Arma letal 3,Lethal Weapon 3,6.7,1992,35000000,321731527,286731527,Pendiente,118
944,Arma letal 4,Lethal Weapon 4,6.6,1998,140000000,285444603,145444603,Pendiente,127
45162,Superman/Batman: Apocalipsis,Superman/Batman: Apocalypse,7.1,2010,3500000,0,-3500000,Vista,78
22855,Superman/Batman: Enemigos públicos,Superman/Batman: Public Enemies,6.9,2009,0,0,0,Vista,66
203801,Operación U.N.C.L.E.,The Man from U.N.C.L.E.,7.1,2015,75000000,108145109,33145109,Vista,116
287947,¡Shazam!,Shazam!,7.1,2019,80000000,365971656,285971656,Vista,132
7485,Shooter: El tirador,Shooter,7.0,2007,61000000,95696996,34696996,Vista,124
297556,La Liga de la Justicia: El trono de Atlantis,Justice League: Throne of Atlantis,7.0,2015,3500000,0,-3500000,Vista,80
9798,Enemigo público,Enemy of the State,6.9,1998,90000000,250649836,160649836,Pendiente,132
1535,Juego de espías (Spy Game),Spy Game,6.9,2001,115000000,143049560,28049560,Pendiente,115
204082,El protector,Homefront,6.9,2013,22000000,43058898,21058898,Pendiente,100
2048,"Yo, robot","I, Robot",6.9,2004,120000000,347234916,227234916,Vista,123
1573,La jungla 2: Alerta roja,Die Hard 2,6.9,1990,70000000,240031094,170031094,Pendiente,124
559969,El camino: una película de Breaking Bad,El Camino: A Breaking Bad Movie,6.9,2019,6000000,0,-6000000,Pendiente,123
13813,Resistencia,Defiance,6.9,2008,32000000,51155219,19155219,Vista,137
74,La guerra de los mundos,War of the Worlds,6.5,2005,132000000,603873119,471873119,Vista,116
59967,Looper,Looper,6.8,2012,30000000,47042000,17042000,Pendiente,118
2112,Payback,Payback,6.8,1999,90000000,161626121,71626121,Pendiente,97
513045,Stuber Express,Stuber,6.8,2019,16000000,22799033,6799033,Vista,105
296524,Marea negra,Deepwater Horizon,6.8,2016,110000000,121790373,11790373,Vista,107
1246,Rocky Balboa,Rocky Balboa,6.8,2006,24000000,155721132,131721132,Pendiente,102
277,Underworld,Underworld,6.8,2003,22000000,95708457,73708457,Vista,121
346672,Underworld: Guerras de sangre,Underworld: Blood Wars,5.7,2016,35000000,81093313,46093313,Vista,91
834,Underworld: Evolution,Underworld: Evolution,6.5,2006,50000000,111476513,61476513,Vista,106
52520,Underworld: El despertar,Underworld: Awakening,6.3,2012,70000000,160112671,90112671,Vista,88
9411,Fallen,Fallen,6.8,1998,0,25232289,25232289,Pendiente,119
8456,Rompiendo las reglas,Never Back Down,6.7,2008,20000000,41627431,21627431,Vista,110
9654,The Italian Job,The Italian Job,6.7,2003,60000000,176070171,116070171,Vista,104
8292,Cuatro hermanos,Four Brothers,6.7,2005,45000000,92374674,47374674,Pendiente,109
399402,Hunter Killer: Caza en las profundidades,Hunter Killer,6.7,2018,40000000,31672678,-8327322,Pendiente,122
449443,Juego de ladrones: el atraco perfecto,Den of Thieves,6.7,2018,30000000,80509622,50509622,Vista,140
1635,La isla,The Island,6.7,2005,126000000,162949164,36949164,Vista,136
66,Poder absoluto,Absolute Power,6.6,1997,50000000,50068310,68310,Pendiente,121
48138,Sin identidad,Unknown,6.6,2011,30000000,130786397,100786397,Vista,113
13804,Fast & Furious: Aún más rápido,Fast & Furious,6.6,2009,85000000,363164265,278164265,Vista,100
339964,Valerian y la ciudad de los mil planetas,Valerian and the City of a Thousand Planets,6.6,2017,177200000,225874228,48674228,Vista,137
7450,Titan A.E.,Titan A.E.,6.6,2000,75000000,36754634,-38245366,Vista,94
7555,John Rambo,Rambo,6.6,2008,50000000,113244290,63244290,Pendiente,93
1576,Resident Evil,Resident Evil,6.6,2002,33000000,102984862,69984862,Vista,96
1577,Resident Evil 2: Apocalipsis,Resident Evil: Apocalypse,6.3,2004,45000000,129394835,84394835,Vista,94
7737,Resident Evil 3: Extinción,Resident Evil: Extinction,6.2,2007,45000000,148412065,103412065,Vista,95
35791,Resident Evil 4: Ultratumba,Resident Evil: Afterlife,6.0,2010,60000000,300228084,240228084,Vista,97
173897,Resident Evil: El capítulo final,Resident Evil: The Final Chapter,6.1,2016,40000000,312242626,272242626,Vista,107
71679,Resident Evil: Venganza,Resident Evil: Retribution,5.7,2012,65000000,240159255,175159255,Vista,96
62835,Colombiana,Colombiana,6.6,2011,40000000,60965854,20965854,Pendiente,108
75174,Infierno blanco,The Grey,6.5,2011,25000000,77278331,52278331,Vista,115
12094,Jackass 2: Todavía más,Jackass Number Two,6.4,2006,11000000,72778712,61778712,Vista,95
9012,Jackass: La película,Jackass: The Movie,6.2,2002,5000000,64282312,59282312,Vista,87
16290,Jackass 3D,Jackass 3D,6.5,2010,20000000,117224271,97224271,Vista,94
457335,Guns Akimbo,Guns Akimbo,6.5,2019,0,835102,835102,Vista,100
8909,Wanted (Se busca),Wanted,6.5,2008,75000000,341432090,266432090,Vista,110
11128,Brigada 49,Ladder 49,6.4,2004,60000000,74541707,14541707,Pendiente,115
240832,Lucy,Lucy,6.4,2014,40000000,458863600,418863600,Vista,90
302699,Un espía y medio,Central Intelligence,6.4,2016,50000000,216972543,166972543,Vista,107
1647,La prueba,The Recruit,6.4,2003,46000000,101191884,55191884,Pendiente,105
11081,Vidas ajenas,Taking Lives,6.3,2004,45000000,65470529,20470529,Pendiente,103
1927,Hulk,Hulk,5.5,2003,137000000,245360480,108360480,Vista,133
254128,San Andrés,San Andreas,6.2,2015,110000000,473990832,363990832,Vista,114
2135,La máquina del tiempo,The Time Machine,6.1,2002,80000000,123729176,43729176,Vista,92
339846,Baywatch: Los vigilantes de la playa,Baywatch,6.1,2017,69000000,177856751,108856751,Vista,116
8698,La liga de los hombres extraordinarios,The League of Extraordinary Gentlemen,5.9,2003,78000000,179265204,101265204,Vista,110
375588,Robin Hood,Robin Hood,5.9,2018,100000000,86493046,-13506954,Vista,116
436969,El Escuadrón Suicida,The Suicide Squad,0.0,2021,0,0,0,Pendiente,0
87516,Old boy,Oldboy,5.9,2013,30000000,5186767,-24813233,Pendiente,114
147441,Exodus: Dioses y reyes,Exodus: Gods and Kings,5.8,2014,140000000,268031828,128031828,Pendiente,150
11846,El padre de la novia,Father of the Bride,6.4,1991,0,89325780,89325780,Vista,105
11862,Vuelve el padre de la novia (Ahora también abuelo),Father of the Bride Part II,6.2,1995,0,76578911,76578911,Vista,106
275,Fargo,Fargo,7.9,1996,7000000,60611975,53611975,Vista,98
457799,"Extremadamente cruel, malvado y perverso","Extremely Wicked, Shockingly Evil and Vile",7.0,2019,0,0,0,Vista,108
11456,Falsa identidad,Domestic Disturbance,5.7,2001,75000000,54249294,-20750706,Vista,92
491418,Familia al instante,Instant Family,7.6,2018,48000000,14700000,-33300000,Vista,118
9574,Flubber y el profesor chiflado,Flubber,5.6,1997,80000000,177977226,97977226,Vista,93
256591,Focus,Focus,6.9,2015,50100000,153962963,103862963,Vista,104
568091,Fractura,Fractured,6.6,2019,0,0,0,Vista,99
18823,Furia de titanes,Clash of the Titans,5.8,2010,125000000,493214993,368214993,Vista,106
18501,Gamer,Gamer,5.7,2009,50000000,40828540,-9171460,Vista,95
1250,Ghost Rider: El motorista fantasma,Ghost Rider,5.5,2007,110000000,228738393,118738393,Vista,110
71676,Ghost Rider: Espíritu de venganza,Ghost Rider: Spirit of Vengeance,4.9,2011,57000000,132563930,75563930,Vista,96
450465,Glass (Cristal),Glass,6.6,2019,20000000,246941965,226941965,Vista,129
2976,Hairspray,Hairspray,6.7,2007,50000000,90450008,40450008,Vista,107
2959,Hasta que el cura nos separe,License to Wed,5.7,2007,35000000,69307224,34307224,Vista,91
623926,Hasta que la boda nos separe,Hasta que la boda nos separe,6.9,2020,0,3306621,3306621,Vista,110
426563,Holmes & Watson,Holmes & Watson,4.4,2018,42000000,40462793,-1537207,Vista,95
2109,Hora punta,Rush Hour,6.9,1998,33000000,244386864,211386864,Vista,98
5175,Hora punta 2,Rush Hour 2,6.6,2001,90000000,347325802,257325802,Vista,90
5174,Hora punta 3,Rush Hour 3,6.3,2007,140000000,258022233,118022233,Vista,91
9595,Hot Shots!,Hot Shots!,6.5,1991,26000000,181096164,155096164,Vista,84
9255,Hot Shots! 2,Hot Shots! Part Deux,6.5,1993,25000000,133752825,108752825,Vista,86
101907,Hulk vs. Thor,Hulk vs. Thor,6.7,2009,0,0,0,Vista,45
15257,Hulk vs Lobezno,Hulk vs. Wolverine,7.0,2009,0,0,0,Vista,37
8355,Ice Age 3: El origen de los dinosaurios,Ice Age: Dawn of the Dinosaurs,6.7,2009,90000000,886686817,796686817,Vista,94
347669,Incidencias,Incidencias,4.7,2015,0,393060,393060,Vista,90
25769,Infectados (Carriers),Carriers,5.8,2009,0,5802422,5802422,Vista,85
1422,Infiltrados,The Departed,8.2,2006,90000000,291465000,201465000,Vista,149
49018,Insidious,Insidious,6.9,2010,1500000,97009150,95509150,Vista,103
57165,Ira de titanes,Wrath of the Titans,5.7,2012,150000000,301970083,151970083,Vista,99
75780,Jack Reacher,Jack Reacher,6.5,2012,60000000,218340595,158340595,Vista,130
137094,Jack Ryan: Operación sombra,Jack Ryan: Shadow Recruit,6.1,2014,60000000,135511030,75511030,Vista,105
352695,Joshy,Joshy,5.5,2016,0,0,0,Vista,93
308266,Juego de armas,War Dogs,6.8,2016,40000000,86234523,46234523,Vista,114
23483,Kick-Ass: Listo para machacar,Kick-Ass,7.1,2010,28000000,96188903,68188903,Vista,117
207703,Kingsman: Servicio secreto,Kingsman: The Secret Service,7.6,2014,81000000,414351546,333351546,Vista,129
287903,Krampus: Maldita Navidad,Krampus,6.1,2015,15000000,61788393,46788393,Vista,98
310131,La bruja,The Witch,6.8,2015,3500000,40423945,36923945,Vista,93
80184,La cara oculta,La cara oculta,7.2,2011,2600000,7033931,4433931,Vista,92
600,La chaqueta metálica,Full Metal Jacket,8.1,1987,30000000,46357676,16357676,Vista,120
394830,La crucifixión,The Crucifixion,5.6,2017,0,6554322,6554322,Vista,90
201085,La cumbre escarlata,Crimson Peak,6.6,2015,55000000,74679822,19679822,Vista,119
223702,La fiesta de las salchichas,Sausage Party,5.7,2016,19000000,140705322,121705322,Vista,89
8980,La gran aventura de Mortadelo y Filemón,La gran aventura de Mortadelo y Filemón,5.6,2003,0,0,0,Vista,88
5595,La habitación de Fermat,La Habitación de Fermat,6.5,2007,0,0,0,Vista,90
21208,La huérfana,Orphan,6.9,2009,20000000,77912251,57912251,Vista,123
49494,La legión del águila,The Eagle,6.2,2011,25000000,27122040,2122040,Vista,114
408220,La Liga de la Justicia Oscura,Justice League Dark,7.3,2017,0,0,0,Vista,75
30061,La Liga de la Justicia: Crisis en dos tierras,Justice League: Crisis on Two Earths,7.3,2010,0,0,0,Vista,75
10781,La matanza de Texas: El origen,The Texas Chainsaw Massacre: The Beginning,6.0,2006,16000000,51764406,35764406,Vista,90
13640,La muerte de Superman,Superman: Doomsday,6.6,2007,3500000,0,-3500000,Vista,75
487672,El Reinado de los Superhombres,Reign of the Supermen,7.1,2019,0,0,0,Vista,87
9374,La muerte os sienta tan bien,Death Becomes Her,6.7,1992,55000000,149022650,94022650,Vista,104
854,La máscara,The Mask,6.9,1994,23000000,351583407,328583407,Vista,101
424139,La noche de Halloween,Halloween,6.5,2018,10000000,253688035,243688035,Vista,120
10144,La Sirenita,The Little Mermaid,7.4,1989,40000000,211343479,171343479,Vista,83
41505,La sombra de los otros,6 Souls,5.9,2010,22000000,851517,-21148483,Vista,112
266856,La teoría del todo,The Theory of Everything,7.9,2014,15000000,123726688,108726688,Vista,123
44040,La trampa del mal,Devil,6.0,2010,10000000,33583175,23583175,Vista,80
65086,La mujer de negro,The Woman in Black,6.1,2012,17000000,127730736,110730736,Vista,95
5876,La niebla,The Mist,6.8,2007,18000000,57096190,39096190,Vista,124
442249,La primera purga: La noche de las bestias,The First Purge,6.0,2018,13000000,137056262,124056262,Vista,97
22586,La princesa Cisne,The Swan Princess,6.6,1994,20000000,9771658,-10228342,Vista,95
299687,La quinta ola,The 5th Wave,5.9,2016,38000000,109906372,71906372,Vista,112
11249,La semilla de Chucky,Seed of Chucky,5.4,2004,12000000,24829644,12829644,Vista,87
102362,La venganza del hombre muerto,Dead Man Down,6.1,2013,0,18074539,18074539,Vista,110
11615,La vida de David Gale,The Life of David Gale,7.5,2003,50000000,38955598,-11044402,Vista,130
298312,La visita,The Visit,6.3,2015,5000000,98450062,93450062,Vista,94
471506,La viuda,Greta,6.6,2018,0,0,0,Vista,98
10204,La vuelta al mundo en 80 días,Around the World in 80 Days,5.9,2004,110000000,72178895,-37821105,Vista,120
18405,La última casa a la izquierda,The Last House on the Left,6.4,2009,15000000,32721635,17721635,Vista,110
9703,La última legión,The Last Legion,5.5,2007,67000000,25303038,-41696962,Vista,110
158011,La última llamada,The Call,6.7,2013,13000000,68572378,55572378,Vista,94
22894,Legión,Legion,5.7,2010,26000000,67918658,41918658,Vista,100
44912,Linterna Verde,Green Lantern,5.2,2011,200000000,219851172,19851172,Vista,114
418078,Llega de noche,It Comes at Night,5.8,2017,5000000,19280931,14280931,Vista,92
80278,Lo imposible,The Impossible,7.3,2012,45000000,198087212,153087212,Vista,107
83289,Rivales,Rivales,6.0,2008,0,0,0,Vista,100
97020,RoboCop,RoboCop,5.8,2014,120000000,242688965,122688965,Vista,113
41733,Salidos de cuentas,Due Date,6.3,2010,65000000,211780824,146780824,Vista,95
82525,Salvajes,Savages,6.4,2012,45000000,82966152,37966152,Vista,131
298250,Saw VIII (Jigsaw),Jigsaw,6.2,2017,10000000,102952888,92952888,Vista,100
4232,Scream (Vigila quién llama),Scream,7.3,1996,14000000,173046663,159046663,Vista,111
4233,Scream 2,Scream 2,6.4,1997,24000000,172363301,148363301,Vista,122
4234,Scream 3,Scream 3,5.9,2000,40000000,161834276,121834276,Vista,116
41446,Scream 4,Scream 4,6.3,2011,40000000,97231420,57231420,Vista,111
41283,Sed de venganza,Faster,6.3,2010,24000000,23081726,-918274,Vista,98
13811,Señales del futuro,Knowing,6.1,2009,50000000,155446362,105446362,Vista,130
11324,Shutter Island,Shutter Island,8.2,2010,80000000,294800000,214800000,Vista,104
439015,Slender Man,Slender Man,4.3,2018,10000000,11817275,1817275,Vista,95
2300,Space Jam,Space Jam,6.8,1996,80000000,250200000,170200000,Vista,87
379686,Space Jam: A New Legacy,Space Jam: A New Legacy,0.0,2021,0,0,0,Pendiente,0
35640,Spanish Movie,Spanish Movie,4.9,2009,33000000,6982465,-26017535,Vista,83
1637,Speed: Máxima potencia,Speed,7.0,1994,30000000,350448145,320448145,Vista,115
37686,Super 8,Super 8,6.7,2011,50000000,260095986,210095986,Vista,112
11665,Superagente 86 de película,Get Smart,6.2,2008,80000000,230685453,150685453,Vista,110
8363,Supersalidos,Superbad,7.1,2007,20000000,121463226,101463226,Vista,113
37135,Tarzán,Tarzan,7.4,1999,130000000,448191819,318191819,Vista,88
72105,Ted,Ted,6.4,2012,50000000,549368315,499368315,Vista,107
214756,Ted 2,Ted 2,6.3,2015,68000000,215863606,147863606,Vista,115
290859,Terminator: destino oscuro,Terminator: Dark Fate,6.6,2019,185000000,261119292,76119292,Vista,120
218,Terminator,The Terminator,7.6,1984,6400000,78371200,71971200,Vista,108
280,Terminator 2: el juicio final,Terminator 2: Judgment Day,8.0,1991,102000000,520000000,418000000,Vista,137
296,Terminator 3: La rebelión de las máquinas,Terminator 3: Rise of the Machines,6.1,2003,200000000,435000000,235000000,Vista,109
87101,Terminator Génesis,Terminator Genisys,5.9,2015,155000000,440603537,285603537,Vista,126
534,Terminator: Salvation,Terminator Salvation,6.0,2009,200000000,371353001,171353001,Vista,115
23168,The Town: Ciudad de ladrones,The Town,7.2,2010,37000000,154026136,117026136,Vista,125
